CAATATGAAACCCTTTTAT	CT
GTGCGTCGATTGCTTCCGG	AC
GGGCGGTCACCGAGAATAA	CA
TGCACCGTATTGCTGTTGA	GA
GCTCCGGCAGCAATATGTA	GC
CCTGGCCCAGAACCCACTC	TT
CTCAGAGCCGCCAGCGATT	GG
GTTAATTTGTACCGTTGGT	CA
GGCCAATCGCCAGACCAGA	AA
CACTTAACCATTCGCCATC	CC
CCCGGCTTTTCGCGCTGCG	AG
TGCCAGTAAAAAAGCCTGA	TT
GCCAGTAAATTCCCGTCAG	CG
CCAGTGGGGCATCGCGCAA	AG
ACATCCAGCGGGATCCCCG	CC
GGTGGAGTAGTTATAGGGA	GA
TTCAACTAATATTCGCTTG	CC
CTCCGGGAGCGGTATTGAA	TC
ATATTCAATGCTGTTGAGG	CC
ATAATTTTTACGGTCGAAC	AC
AACCCCGCAAGCACCTGCC	AT
GTATTGAACAGCGCCAGTG	GT
GCCAGCTCTTGACGAACGG	AC
CCAATGGCAGCGGGAAGTG	GC
GAGCAAAAGTTGATACCCG	GT
GATAACGGTATGGTGATCT	AG
GACGCCGCAGCGCCCTGTG	CG
TCTTCCATATTGTTGGCGG	CC
TGAGGCTTAACGCCGGGGC	AT
CTGTTGAATTGCTGCCAAT	GG
AGCGTGCCACATCAACTTC	CA
CGCAGGCAAATAGCGTAGA	TA
GCACCAGCGGGACATTTCC	GC
TGATTCACATAAATTAACA	CT
TCGCTCCCGGTAGAGTGAT	TG
ATACCCCTGATAAACCGTA	AC
GCTCAGAGCCGCCAGCGAT	AT
TTTTCATCTGCTCTCCTTG	GT
GGCTTTGGCTGTATCGGCA	GA
CCATTCCCATTGACCCTAA	CG
CTCCCGGTAGAGTGATGCC	GA
GTTGGAACACCGTTAATTT	TG
TGTTGAATTGCTGCCAATG	CC
CTGGTGCAATTTGACGGTA	GA
AAAAACCAGTGGAGCAAGT	CA
GTTCTGCACCTATGCGATA	GA
AGCGTTCAATAAAAGGCAC	AT
GCCGCATTGACCACCAGCA	GC
AAATAGCGTAGAATGTCAG	CC
CCAGCGGGACATTTCCCAT	AC
TTCGCCAGCGGGCACGACG	CC
AGAGAAGACCGTAAACGGC	GG
TAACTCCTTAATTCCGCAA	TT
GTCGGCAGCGTAGCGGATA	GT
GCATGAACCTGTCGGTGTC	GG
TCTGCTCTCCTTGTTAATT	AT
CATGATTTGCCAGTAAAAA	CA
AGCTGTCGGTCATGGGATT	TT
TTAATTCCGCAATTTCACC	CT
TCCCCATTCCCCCGCATTA	AA
ACCGCAAACCACTGGGCCA	CT
AATCTTGATCATGATTTCG	CC
TATTTGAAATAGATCTGTT	GT
GTGTGACTACGCCGGAGGT	TC
TTCTTTCCCGTAACCCGCG	CT
CCCACTGCCGGGCCAGGCC	GA
GGGCCAATATTACCTTTCG	CC
CTCTGTGTGACTACGCCGG	GA
GCCCTTGCAGGCAGGAAAG	AC
ATGGATAAATTAGCTGCAA	CA
GTCGATTGCTTCCGGCATT	CT
ACATATGACAGTGCTGCTC	GC
ACTGGCGCATCCAGCATTT	AC
ATTTCTTGCGCATCAGCAC	AT
ACGGGTGCCAGTCGTTCAA	CA
ATAGCCAGTGCCTGATACT	FG
GGCACGCCGGGGAAATGGT	CT
CATGACGCATCCGGTTTTC	AG
GGCTTCTCCCTGAATTTCC	AA
TAGTTGCGCCGCGCACGTT	TT
GCTTTCACCGCAAACCACT	GG
GTCGCCAAATCATCCTTGA	CG
AAAAACTCTCTTTGGGCTC	TG
TGAGAGGCAGCGTGCCACA	TT
AACTCCTTAATTCCGCAAT	TT
TGTTGCGATACAGCGCCAG	TA
AGGCGTCATCACCGAAGTT	AG
CGGAGAGAAGACCGTAAAC	CG
AATTAGCTGCAAAACGAGG	AC
GCCATCACATGGACTTGTT	TC
ATCGGCGATAACGCCAATC	CT
AGTGATGCCAGAGAAAATC	GT
AACCTGTCGGTGTCGCCAG	GT
GCCCGTTACCAGTGGGGCA	CT
GTTAGCGGCTTTTACTGCA	CC
CTGTTTGCAACCTTGCTGT	TT
TTACTGCCGTACCGGGTTT	AC
CCAGTGCCAGGTCGATGTC	TT
GATAAATTAGCTGCAAAAC	GG
CAGAAACCCCGCAAGCACC	TT
GAGTGATGCCAGAGAAAAT	AC
TTTTCGGCAAACGTCGCGG	TC
ATCATGGATAAATTAGCTG	CC
TTAACCATTCGCCATCCGC	CG
TGCGATAAACTTTTCCGGC	AA
ATGGTAGCTGAAAAAGGCA	GT
CGTATTGCTGTTGAATTGC	CT
TTCCGGCATTTTACCTGTT	CG
ATCGATAAATACTGCCCGG	TT
GCTCCCGGTAGAGTGATGC	CC
GCATATTCCAGTGCCAGGT	TC
AAAAAGGCATTGTCAGTAT	GT
GCTCCCATTCCCATTGACC	TC
GAAAGCGCCGTCGACCATG	GT
GCTGCAAAACGAGGCATTG	AC
GATAACTGCGCTATCGTCT	TT
GGTAACCGGGCCAATATTA	CC
CACCGTTAATTTGTACCGT	AT
AATTTTTACGGTCGAACCT	TA
GTTACTGGCGCTGGTGAAC	CA
AGTTGATTCATTACGAACA	CA
TGTCGAGAGCATCCATTAA	GG
AATGCATATTCCAGTGCCA	CG
GGCGGCATTGGTCACGACG	CT
GTCATACATCACATCCAGC	CG
CAGATGTTGTGCAACGCCT	TG
GTGGCTTCAACCACTGGAC	TA
CATGAACCGGAGAGCACTA	GC
GACGGCTGAATGCGGGGTG	CT
TGCAATTTGACGGTAATGT	GG
AGCGGGCACGACGCCTGCC	CA
TTCAAAGGCAATATCGCTA	GC
GATAACGCCAATCTTGATC	CA
TGTACCGTTGGTAGACCGT	TT
CAGAGTTTCAATTGAGAGG	CC
CATCCAGCGGGATCCCCGC	AA
AGACAGGCTTATCCAGTGC	GG
CGCCAGATCCTGTGCGATG	CC
CGGCAGCAATATGTACGCC	CC
AAAAGGCATTGTCAGTATT	AG
GGAGAAGAGATAATGAGGC	TT
GCAGCAATATGTACGCCCG	GC
GTGTTATTTTATGTGAACT	TA
GTGCTGGCGGTGGCAAAAA	AC
AGGGTGGAGTAGTTATAGG	CG
AGGCACTTCGGTGAACATC	AA
GGCCAATATTACCTTTCGC	GC
GCCTGTTTCACCAAACAGC	CA
AAGTACACTTTCCTGGCCC	CA
AGCATCTTCGCCAGCGGGC	CA
GTCCGGGAAGGGCGGATAA	CT
ATTGTCAGTATTGCTGAAC	CT
ATGTACGCCCGCTAACAAC	TT
CAAGCACCGCGTAGCGGTA	TG
CGCTTCAACCAGACGGGGA	GA
CTTAACGCCGGGGCTGAGT	GG
TTCAATGCTGTTGAGGCCA	AA
CTTAACCATTCGCCATCCG	AC
ACTCTCTTTGGGCTCGTGA	AA
TGAGCGCCAATGCATATTC	TC
AGCACCAGCAGTGCGTCCA	CG
GATTCACATAAATTAACAT	TT
TTCGCTCCCGGTAGAGTGA	TT
GATGCCAGAGAAAATCTTG	TA
TCACATGGACTTGTTCACA	AA
ACATATTCAATGCTGTTGA	AG
GCAACGGCTTCCAGCACGG	GG
CATCCGCATCACCACGTAT	CG
CGCAAGGCTTCTCCCTGAA	GT
GGCACCAGCGGGACATTTC	AC
GCAATTTCACCTGCGGTCA	CG
ACCACTGGACAGGAGCGCG	AT
GCGTTCAATAAAAGGCACT	AT
TGTCAGCAGGACAAAGGAA	AG
CTGGCTTTTTGTGCACCGT	AA
TTGCGCCGCGCACGTTTCG	GC
TGTTGGAACACCGTTAATT	CT
AATATCTCCGGGAGCGGTA	TT
AGTAGTTATAGGGAAACAG	GA
CCCGGTTCTGCACCTATGC	TG
CCCAGGTAGAAAGACCTGC	CG
AATTTCCAGATGGTGTTCG	GG
GCTGGCGGTGGCAAAAACC	TA
TTTCTACTGCCTGACTGGC	GT
TCCCATCCGCATCACCACG	TT
CAGCATCGAACCCGGCTTT	AT
GGATTTGCAGGGTGGAGTA	TG
TAGATCTGTTTGCAACCTT	AG
CGCCGCGCACGTTTCGCAG	GG
GAGGCAGCGTGCCACATCA	AA
GTGCAACGCCTGTTTCACC	TA
AGCGTTAGTTGCGCCGCGC	AA
TCCCGGTAGAGTGATGCCA	CG
TTCACAATTGAGCGCCAAT	GG
GGCCAATGGCAGCGGGAAG	AT
AACCTTGCTGTTGCAACCA	CG
CCGTTAATTTGTACCGTTG	AG
GCCGCTGCGGATCGAGATT	AG
ATCCTGTGCGATGCGTTTA	GT
CGGCGAAGCGTTCAATAAA	GA
CCGGCGGCATTGGTCACGA	TC
GCTGTATCGGCAACCAGAC	GC
GTGCCAGTCGTTCAAAGGC	GA
ATTGCGCTTCAACCAGACG	GG
CTGCAAAACGAGGCATTGC	GA
TCAACCACTGGACAGGAGC	TG
TCCGCCAGATCCTGTGCGA	TT
GGCACTTCGGTGAACATCA	AT
GCTGTTGAATTGCTGCCAA	TT
TTTACCGGGTGATGGCGCA	AT
TTATGTGAACTAAGCGTTA	TG
TCCTTGTTAATTTAAGTGA	CT
CACCAAACAGCACCTGTTT	TA
GGCATTGTCAGTATTGCTG	AA
AGTGCCTGATACTGGCTGG	CA
TTACTGCACCACCAGAAAC	TT
CTGGCGATATCCGTCGCGC	AC
CGGGACATTTCCCATCCGC	GA
TTTCCAGATCGAATCCAGC	AC
TTTCGCTCCCGGTAGAGTG	AA
AGCGGATATTATCGATAAA	TT
ATCTTGATCATGATTTCGC	AT
ACCAGAAACTGGCGCATCC	CA
CATCTGCTCTCCTTGTTAA	TT
CCAGCACGGGTGCCAGTCG	TT
CCCCATTCCCCCGCATTAA	TT
ATTGCTGTTGAATTGCTGC	TC
GCAAGTGCCATCGCTTCGG	TC
CCCGGTCGGTAATAAGGCA	GC
ATTACGAACAAATACCCCT	CG
AGGAGCGCGTTTTCAGGCT	CG
AATGCGGGGTGTAATCGCC	GA
GATACTGGCTGGAGAAGAG	TA
CGATTGCTGTGTGGCTTCA	GA
TATTGAACAGCGCCAGTGT	GC
CCAGCTCTTCCATATTGTT	TG
GCGTCAGTGCTGGCGGTGG	TC
TTTCACCGCAAACCACTGG	CG
ACTTAACCATTCGCCATCC	CG
TATGGTGATCTGATTCACA	GT
ATCGGCAACCAGACCAAGA	TT
TTACCCACGGCACGCCGGG	TG
TGGAGTAGTTATAGGGAAA	GC
CCAGATCCTGTGCGATGCG	GT
GAGAATAAAAATCAGCTTT	CG
AACGGCATCCACACCTTGT	GT
CGGTTCTGCACCTATGCGA	CT
CGCCCACTGCCGGGCCAGG	GC
TAAATTAACATTGTGTGTT	AA
CAATATCGCTACCGGAGGC	GC
GGCGGTCACCGAGAATAAA	GA
CTACCTGGCGGTTGGTCAT	GT
ATATTATCGATAAATACTG	GC
TGCGCTTCAACCAGACGGG	TG
GTGCAATTTGACGGTAATG	GT
GCTTGCCGTGTGGCGCAAA	CG
CGAGTGAGACAGGCTTATC	GC
CCAATATGAAACCCTTTTA	GT
GCGATATCCGTCGCGCCGG	GT
TCGAACCTAGTCCCGGTTC	GT
TCTTCGCCAGCGGGCACGA	AC
GGTTTGTCACCACTTAACC	GA
TAAGGGCGAGTGAGACAGG	TC
AATACCCCTGATAAACCGT	AA
GACAGAATGAATGTGTCAC	GA
TGCCAGTTCGTGTGCATAA	CG
GCTGTTGCAACCAGCTCAG	TA
CCAGCTCAGAGCCGCCAGC	AG
GTGTCGAGAGCATCCATTA	CA
TCCCATTCCCATTGACCCT	CA
TTGCCAGCCGAACCGGTTG	AC
ATATTCCAGTGCCAGGTCG	CA
CGAACGGCATCCACACCTT	AG
GCATTGGTCACGACGTCAT	GA
GATCTGTTTGCAACCTTGC	AT
TATGTACGCCCGCTAACAA	AC
TCCCTGAATTTCCAGATGG	CT
ATAATCCCCATTCCCCCGC	GA
GCAAGGCTTCTCCCTGAAT	CT
AGGTAGAAAGACCTGCGCG	CG
GCGCTTCAACCAGACGGGG	TA
GCTGCCAGTTCCGCCAGAT	TC
CGTCATACATCACATCCAG	AC
CGCATCCAGCATTTCCAGA	GT
CAAATACCCCTGATAAACC	AG
TTTGCCGTTTCCTCCAGCT	CC
ATGAACCTGTCGGTGTCGC	CC
CCGCAGCGCCCTGTGGATT	GG
AAAAAGCCTGATTGTCTGC	AT
AATATAAGCGCTGGAAGAT	GA
CATCCGCGGCGACTTTGGA	CA
GGTTTTGCTCCAGTTGCTT	TT
GAGAGCACTACGCCGCGCC	GC
AGGAAGGAGCAAAAGTTGA	AT
CAGATGAAAGAGCACCTCT	CT
CGCCATCCGCGGCGACTTT	TG
ATTTTTACGGTCGAACCTA	AG
GGCGGCTTCTTGCAGGCTT	TT
TATCGTCTTCTTTCCCGTA	CA
GAAACCCCGCAAGCACCTG	AC
GACCGTTTTCCACCAGAAA	AA
CCGCGCCCAGCGAGCGGAC	GG
GTTGAGAAAACAGTGTTTC	AT
ACAAATACCCCTGATAAAC	AC
TGAATATAAGCGCTGGAAG	GA
TCAATTGAGAGGCAGCGTG	TC
CGGGGCTGAGTGCTTCAAC	CT
TGCCAGTTCCGCCAGATCC	CT
GTCGGTCATGGGATTTACC	TG
GGAAGGAGCAAAAGTTGAT	AA
CCAGGCTCTGTGTGACTAC	CG
ACGGGCTGCAAGTGCCATC	CG
GAGAAAATCTTGATAACTG	AC
CTGTTGAGGCCAATGGCAG	GC
GCCGCAGCGCCCTGTGGAT	CT
TGCAGGCAGGAAAGCGCCG	TT
CGCAAACCACTGGGCCATG	CA
GTTTGTCACCACTTAACCA	GT
TAGCGTAGAATGTCAGCAG	AG
CGGCTTTTACTGCACCACC	GA
TGGCAATCCGCGTCATCTC	CC
GCACCTATGCGATAAACTT	TT
GAGCACCTCTTTCGAGGGT	AT
CGCCATCCACCACATGACG	TC
CAGTGCCAGGTCGATGTCT	CG
CAGTTTTTCGGCAAACGTC	CG
GCACGGGCTGCAAGTGCCA	CT
TGGATTTGCAGGGTGGAGT	TA
TGCCATCGCTTCGGCTCCG	GG
CCGGGTTTCAGATGTTGTG	AC
AGTAAAAAAGCCTGATTGT	CC
TGCAAAACGAGGCATTGCA	CT
GAAAGCCGCTGCGGATCGA	GG
TTGTCTGCTGCCAGTTCCG	AC
TCTTTGGGCTCGTGAAAAA	CA
GCTCACGTCCGGGAAGGGC	TG
TACCGACATGAAACTCAGA	AT
TCAGTGCTGGCGGTGGCAA	GA
CGCCGTCGACCATGTGCTG	GT
CACATCAACTTCACGGGCT	CG
GTACCGTTGGTAGACCGTT	TT
TGGTAGCTGAAAAAGGCAT	AT
TTGCTGAACTAACGGACAG	AA
AATCATCCTTGAGATGGTA	AG
TGGTCATTTGAGAGCATGA	TA
GGATTTACCGGGTGATGGC	GG
TCCCAGGCTCTGTGTGACT	TA
AACATCCAGGAATTTCCGG	GC
GGCACGACGCCTGCCATCA	GC
CAATAAAGCGTGTCACGCC	AT
TGCGATGCGTTTATCGCCC	GG
ATCTCCTCTCGCAAAGACT	CG
ACCCACTCTGCCAGTTCGT	AG
AATCAGCTTTGCCGTTTCC	AT
CCCAGAACCCACTCTGCCA	GG
GATCGAGATTGCCCAGGCA	GT
CAGCATTTCCAGATCGAAT	CC
CGGCAGCGTAGCGGATATT	TA
TTGGATTTGCAGGGTGGAG	TT
CCGCCTGCGACAATAAAGC	AG
TATAAGCGCTGGAAGATAA	AC
CACCGTATTGCTGTTGAAT	GT
CGATAACGCCAATCTTGAT	GC
CTGTTGGAACACCGTTAAT	CT
ATACAGCGCCAGATGAAAG	GA
CGACCATGTGCTGTGCAAA	TT
ATATTACCTTTCGCCGTAC	AT
TACCGTTCAGCATCTTCGC	GC
TCCAGATGGTGTTCGGTCA	TG
TGCAACCAGCTCAGAGCCG	TC
GGCGAAGCGTTCAATAAAA	CG
GAACCGGAGAGCACTACGC	TC
GTGCGTTTACCCACGGCAC	AG
TATTATCGATAAATACTGC	AC
AGTCGTTCAAAGGCAATAT	CC
CGAACATCCAGGAATTTCC	TG
CACACCTTGTTCGAAAACA	CT
TTCCAGATGGTGTTCGGTC	TA
CGGTGGCAAAAACCAGTGG	GA
GTCGGTGTCGCCAGTAAAT	TT
AGTGGGGCATCGCGCAAGG	CC
CGCATCCGGTTTTCGAACA	AT
AGTGCGTCCAGTTTTTCGG	CC
GAACTAAGCGTTAGTTGCG	TC
CGTTACCAGTGGGGCATCG	CC
GGATTGTTGCGATACAGCG	CC
CCCCCGCATTAATATCTCC	TG
ACCAGTGGAGCAAGTACAC	AT
GCATTAATATCTCCGGGAG	CC
TATTGTTGGCGGCTTCTTG	AC
GTACGCCCGCTAACAACTG	TG
CAGAGCGGTAGCAATTTCT	CT
TGCGGGGTGTAATCGCCAT	AC
TGTCGGTGTCGCCAGTAAA	CT
CTCTTTCAACGTAGCGCAG	CG
GGATTCGGCCAGCAGTTGA	CT
GGGCGGATAATCCCCATTC	AC
CATTAAGGCATCGGTAACC	CG
TGTTTGATATTGTGAATAT	TA
GGCGATATCCGTCGCGCCG	TG
CTTTGGAAAGCCGCTGCGG	AA
CACCAGAAACTGGCGCATC	CC
TCCAGCATTTCCAGATCGA	AA
AAAGGCACTTCGGTGAACA	AT
TGCTTCGTGCTCACGTCCG	GG
TTTCCTCCAGCTCTTCCAT	GA
GCCTGATTGTCTGCTGCCA	AG
TAAGCGCTGGAAGATAACG	AG
ATTCCCAGGCTCTGTGTGA	TC
GTTTTCTTGCGCCCACTGC	CC
ACAGCATCGAACCCGGCTT	CT
TCATTTGAGAGCATGAACC	GG
ACATCATGGATAAATTAGC	AT
TGGTGCAATTTGACGGTAA	CT
GCGTCATCACCGAAGTTGC	GC
TGCCATCACATGGACTTGT	CT
GCCAACGATACCGACATGA	AA
TAAGCCAACGATACCGACA	CT
AACCAGCTCAGAGCCGCCA	CG
ACAGCACCTGTTTAACCTG	AG
CTGGCGCATCCAGCATTTC	AC
GGTTGGGCCAATATGAAAC	TC
GGCAGGAAAGCGCCGTCGA	AC
TCTCCTCTCGCAAAGACTG	AC
CCACCAGCACCAGCAGTGC	AG
CTTGCGCCCACTGCCGGGC	TC
GCTAACAACTGGTGAATAA	CT
CCTCTTTCAACGTAGCGCA	GG
ATAGCCGCGCTGAAAGAAT	CG
TGATAACTGCGCTATCGTC	TT
CAACTTCACGGGCTGGTGC	TA
GAAGATAACGGTATGGTGA	GT
TGACCACCAGCACCAGCAG	TT
CAAAAACCAGTGGAGCAAG	GT
TCAGCATCTTCGCCAGCGG	TG
AGTGGAGCAAGTACACTTT	CC
CTCTTCCATATTGTTGGCG	GG
AAGACTGCTCTACTTTTGC	AG
AATGTCAGCAGGACAAAGG	GA
TCGCCAGACCAGAACCGCC	AC
TAGACCGTTTTCCACCAGA	GA
ACCCACGGCACGCCGGGGA	TA
CGGCGTTATCAGAAACCCC	GG
GAGCGGTAGCAATTTCTTG	AC
ATCAGCACTAGCGATAGTG	CG
AGTGCCATCGCTTCGGCTC	AC
GTCCAGTTTTTCGGCAAAC	CG
GAGAAGACCGTAAACGGCG	AT
TGGAAGATAACGGTATGGT	CG
GGTCTCACCGCCTGCGACA	AA
TACTGCACCACCAGAAACT	TG
CGCTCCCGGTAGAGTGATG	TC
GTCATTTGAGAGCATGAAC	GC
AAACCGTACGTCCGTTGAC	TC
GTGTGCTTCGTGCTCACGT	CC
AAACCATTACTGCCGTACC	GG
GATATTATCGATAAATACT	GG
TATTGCTGAACTAACGGAC	GA
AGAAAACAGTGTTTCTACT	GG
CAATCTTGATCATGATTTC	CG
GGGTGATGGCGCATCCCGG	CA
ACCATTACTGCCGTACCGG	AG
TAGCGGTAGCCCTCTTGCT	GG
ATCATGATTTCGCTCCCGG	GT
AGCGTGTCACGCCTTCCGC	AT
CACTACGCCGCGCCCAGCG	GA
GATAGTGGAAGAAACCATT	CA
AGGGCGGATAATCCCCATT	AC
GCCAGCCGAACCGGTTGCA	TT
TCTTGCTGTAAGCGAGCCA	CG
TCGCCATCCGCGGCGACTT	TT
TGGAAGAAACCATTACTGC	GC
CCAGACCAGAACCGCCCGT	GT
CCGAAACGACGCCGCAGCG	GC
TATCCGTCGCGCCGGTAAA	AA
CGAGGGTTTGTCACCACTT	TA
CGGATTCGGCCAGCAGTTG	CA
GGGCTGCAAGTGCCATCGC	CT
CGTACTGTCGAAAGTAGAG	CC
AACCTAGTCCCGGTTCTGC	GA
TGGATTGCGCTTCAACCAG	GA
CAGCGTGCCACATCAACTT	GC
TAGTTATAGGGAAACAGAA	GA
GCATTAACTCCTTAATTCC	TG
GGACATATGACAGTGCTGC	CT
GCGCGGATTGTTGCGATAC	AA
GACATGAAACTCAGATCCC	CG
CGAACCCGGCTTTTCGCGC	TT
ATCCAGTGCGTTTACCCAC	TG
AAGGAAGGAGCAAAAGTTG	AA
TCTTGATAACTGCGCTATC	AG
TTATCGATAAATACTGCCC	AG
ACAGGCTTATCCAGTGCGT	GT
TTTGGAAAGCCGCTGCGGA	CT
CGTCTTCTTTCCCGTAACC	TC
GACATTTCCCATCCGCATC	GA
GGTGTGAACGGACGAATAA	TC
CGGTACCGTTCAGCATCTT	CC
CACGGGTGCCAGTCGTTCA	GA
CGCTTCGGCTCCGGCAGCA	TA
GTTGCTTTTGGATTTGCAG	AG
CAGTGCGTTTACCCACGGC	CA
CGTACCGGGTTTCAGATGT	CT
TCACCACTTAACCATTCGC	GC
GGAGAGAAGACCGTAAACG	CG
AATAGCGTAGAATGTCAGC	AA
TCCAGTTTTTCGGCAAACG	GT
ACATCCAGGAATTTCCGGC	AG
GACTGCTCTACTTTTGCGA	AA
GTGGCGCAAAGCGGTCGGC	TA
AGGTAAAAGCAGCGACAGA	CT
TGCATAGCCGCGCTGAAAG	TA
TGCCTGACTGGCTTTTTGT	CG
AGTTGATACCCGTAGAGCG	AT
CAGATCCCGTTTTCATCTG	TC
GCGCTATCGTCTTCTTTCC	TC
TTACAGCGCGGATTGTTGC	TG
CCAGATCGAATCCAGCCAG	TA
CCAGAGCGGTAGCAATTTC	GT
CGGCATTTTACCTGTTGGA	CA
CTAATATTCGCTTGCCGTG	AT
ACTGGCAATCCGCGTCATC	AT
GCTGTGCAAATGCACCACC	TG
TCGTCTTCTTTCCCGTAAC	AC
ACCTGGGCCGCATTGACCA	AC
TGCCGTGTGGCGCAAAGCG	TG
GACAGTGCTGCTCCCATTC	TC
TCTCACCGCCTGCGACAAT	GA
GATTTACCGGGTGATGGCG	GC
CGGTAATAAGGCACCAGCG	TG
AAATGCACCACCGCTTTAC	CA
CGGGAAGGGCGGATAATCC	CC
CTGTTTAACCTGGGCCGCA	CT
TTCAGGCTGATCACCAGTG	TC
CATATTCAATGCTGTTGAG	AG
ATAAGCGGCCAGAGTTTCA	CA
TGTGTTATTTTATGTGAAC	GT
TCTCCTTGTTAATTTAAGT	CG
GTTCGAAAACATGTGCCGA	TA
ATTTCCGGCGGCATTGGTC	AA
GAGATGGTAGCTGAAAAAG	TG
CAGTAAAAAAGCCTGATTG	CT
ACCCGGCTTTTCGCGCTGC	AG
GTAGCGCAGGCATTGCTGT	CT
TTTCCCGTAACCCGCGTTA	CC
CTTGCTGTTGCAACCAGCT	CC
CGCGGACATATGACAGTGC	GT
AGCGGTAGCCCTCTTGCTG	TT
CATCTCCTCTCGCAAAGAC	TT
GCGTTATCAGAAACCCCGC	GA
CAGTGTCAGATGGTTTTGC	CT
GTTTTCCACCAGAAAACTG	CG
TGCGATACAGCGCCAGATG	TA
GGTGAACATATTCAATGCT	TG
CCAGTAAAAAAGCCTGATT	GG
TAACGGTATGGTGATCTGA	AT
AACGCCTGTTTCACCAAAC	CA
CGGTCGGTAATAAGGCACC	CA
AACAAAAATATCGACGGCT	TG
TGCCAATGCGTCAGTGCTG	CG
CTTGTTCGAAAACATGTGC	CC
GTGCTTCAACTAATATTCG	AC
CCAACGATACCGACATGAA	GA
AAAACCAGTGGAGCAAGTA	AC
CACCACATGACGCATCCGG	CT
CAGGCAAATAGCGTAGAAT	GG
TCAACTTCACGGGCTGGTG	AC
AACCAGACGGGGAAGATAG	CC
CTTTCAACGTAGCGCAGGC	TA
ACTGGCTGGAGAAGAGATA	TA
GGTTTCAGATGTTGTGCAA	GC
CGATAGTGGAAGAAACCAT	GT
GTTTCGCAGGCAAATAGCG	CT
AAGCACCTGCCTCTTTCAA	CC
CCGCAAACCACTGGGCCAT	AG
TTTGAGAGCATGAACCGGA	AG
TTCAGCATCTTCGCCAGCG	GG
ACTGCACCACCAGAAACTG	TG
TATCGCTACCGGAGGCCAT	AG
TCGGTGTCGCCAGTAAATT	GC
AGAGTGATGCCAGAGAAAA	TT
GTTGCTGCTGTCCAGCCCT	CT
GCTGCTAACCGCGCCGCTA	CG
CCCTGTGGATTGCGCTTCA	GA
TTTTGTTTGATATTGTGAA	AT
GAAAACTGGCGATATCCGT	AC
AGCAGTGCGTCCAGTTTTT	CC
AACCATTCGCCATCCGCGG	TC
ACCGAGAATAAAAATCAGC	CT
AAATACCCCTGATAAACCG	CT
TGAACTAAGCGTTAGTTGC	GG
ATCATCCTTGAGATGGTAG	AC
ATACTGCCCGGTACCGTTC	AA
CCATTCCCCCGCATTAATA	CT
CAATTGAGAGGCAGCGTGC	TC
TAACCCGCGTTACTGGCGC	GT
ACAGCGCGGATTGTTGCGA	TT
TTTTGGATTTGCAGGGTGG	CA
GTTTCACCAAACAGCACCT	TG
TTTCTTGCGCCCACTGCCG	TG
AAGGCACCAGCGGGACATT	TT
TGCTGCCAGTTCCGCCAGA	CT
ATAAGGCACCAGCGGGACA	AT
CCACCAGAAAACTGGCGAT	TA
ACGTAGCGCAGGCATTGCT	AG
CTATCGTCTTCTTTCCCGT	GA
GCGGCGACTTTGGAAAGCC	CG
GCAATTTCTTGCGCATCAG	AC
ATTGTCTGCTGCCAGTTCC	GG
GCTTTTACTGCACCACCAG	GA
CCATATTGTTGGCGGCTTC	TT
CGCCCTGTGGATTGCGCTT	GC
CGGAGAGCACTACGCCGCG	CC
GTTAATTTAAGTGATATTT	TT
TCTTGCGCATCAGCACTAG	TC
AAAGACTGCTCTACTTTTG	CC
GCGGCTTCTTGCAGGCTTT	GC
CCTGATAAACCGTACGTCC	CG
CGTATGGTGTGAACGGACG	AA
TCCCCCGCATTAATATCTC	TC
GCGACAATAAAGCGTGTCA	TC
CCATCCACCACATGACGCA	GT
CGCCTTCCGCTGCTAACCG	AC
ACTTTCCTGGCCCAGAACC	CC
GGTAAAAGCAGCGACAGAT	AT
AATCCGCGTCATCTCCTCT	CC
CACTGGGCCATGATTTGCC	CA
ATTCGCCATCCGCGGCGAC	CT
TCTCTTTGGGCTCGTGAAA	CA
ACACTTTCCTGGCCCAGAA	TC
CTCTGCCAGTTCGTGTGCA	AT
CTGGTGAACATATTCAATG	GC
ATGCGGGGTGTAATCGCCA	AT
CGCTACCGGAGGCCATGAC	TA
CCGTCGCGCCGGTAAAATC	TA
AGGCACCAGCGGGACATTT	AC
CCAGTGCGTCGATTGCTTC	AC
CGGCGATAACGCCAATCTT	TG
GGTGATCTGATTCACATAA	TA
TGCTAACCGCGCCGCTAGT	CT
GTCGCCAGTAAATTCCCGT	TC
TAGCTGAAAAAGGCATTGT	GC
GGGCTGGTGCAATTTGACG	CG
CATTTCCAGATCGAATCCA	GG
CTGTGTGACTACGCCGGAG	TG
CCAGTCGTTCAAAGGCAAT	GA
GAGCAGTATTTGAAATAGA	AT
CACATGGACTTGTTCACAA	TT
CGCGTTTTCAGGCTGATCA	GC
GCGGCGTTATCAGAAACCC	CC
GGTGAATAATTTTTACGGT	TC
ATTGACCCTAAGCCAACGA	CT
AAAAATCAGCTTTGCCGTT	TT
TTGCGATACAGCGCCAGAT	GG
CTTGCCGTGTGGCGCAAAG	GC
CGGACGAATAACGTTGCTG	AC
GGGAAATGGTTGGGCCAAT	GA
TTTGCGAAATCGCTCATGA	TT
ACCAGCACCAGCAGTGCGT	CC
AATGAGGCTTAACGCCGGG	TG
CCGGTTCTGCACCTATGCG	CA
AGATGGTTTTGCTCCAGTT	CG
AGAAGACCGTAAACGGCGT	GG
TAAGTGATATTTTGTTTGA	TT
CCCGTAACCCGCGTTACTG	TG
CTGCGCCCCAGGTAGAAAG	TA
TTCCACCAGAAAACTGGCG	TA
CTTCGGTGAACATCATGGA	AT
CGCGCTGAAAGAATGAACT	CG
AACAAATACCCCTGATAAA	GC
GTCGAGAGCATCCATTAAG	TG
GTTGAGGCCAATGGCAGCG	TG
TCATTACGAACAAATACCC	TC
AGCGACAGATTGCCAGCCG	CA
TTCGAAAACATGTGCCGAA	GA
CAAGATCCTTAACAAAAAT	CA
GGTCAGATAACGGATCGGG	CC
CGCCCGCTAACAACTGGTG	AA
GTGCCACATCAACTTCACG	CG
TTTCCGGCGGCATTGGTCA	AC
CCAATCGCCAGACCAGAAC	GC
GCCGCGCTGAAAGAATGAA	AC
TGCGACAATAAAGCGTGTC	CA
ATCTGTTTGCAACCTTGCT	GG
ATTCCACAGCATCGAACCC	AG
CTGCGCTATCGTCTTCTTT	AC
ACAGCGCCAGATGAAAGAG	TC
GAGCGCCAATGCATATTCC	TA
GTGATGCCAGAGAAAATCT	AT
CCGCGCCGCTAGTTGAGAA	AA
TGGCGCAAAGCGGTCGGCA	GG
AAGAAACCATTACTGCCGT	GA
CAGAACCGCCCGTTACCAG	CT
ATCATCGGCGATAACGCCA	AA
TCTACTTTTGCGAAATCGC	CT
CCCGTAGAGCGTCGCCAAA	AT
TCGGTCAGCGCATCAAGCA	TC
CGTGTCGAGAGCATCCATT	GA
CAGCATCTTCGCCAGCGGG	TC
ATTGCCAGCCGAACCGGTT	GG
TGAAACCCTTTTATTCCCA	AG
CCGGAGGCCATGACAGTCA	AT
GTTTTTCGGCAAACGTCGC	AG
TGCCAGAGAAAATCTTGAT	AA
TTGATATTGTGAATATAAG	TC
CTGCCAATGCGTCAGTGCT	GG
CACCTTGTTCGAAAACATG	AT
TAACGTTGCTGCTGTCCAG	AC
TTGCCAGTAAAAAAGCCTG	TA
CCCTAAGCCAACGATACCG	AA
GCGTTTACCCACGGCACGC	TC
CCAGAACCGCCCGTTACCA	AG
GACCTGCGCGGACATATGA	AC
GCCGCCAGCGATTGCTGTG	AT
CGCCAGCGATTGCTGTGTG	CG
CCAGTTTTTCGGCAAACGT	TC
TGCTCCAGTTGCTTTTGGA	TT
CCTGTTGGAACACCGTTAA	AT
GCAGGCAGGAAAGCGCCGT	TC
CTGCCGGGCCAGGCCAATC	AG
GGCTTCTTGCAGGCTTTCA	CC
TTCCCAGGCTCTGTGTGAC	AT
CAACGATACCGACATGAAA	CC
AGCACTACGCCGCGCCCAG	GC
TCAATGCTGTTGAGGCCAA	TT
ACCGGGCCAATATTACCTT	AT
ATTTCCAGATCGAATCCAG	CC
GCTTTTGGATTTGCAGGGT	TG
CGGATCGGGCGGTCACCGA	AG
GCTTCGTGCTCACGTCCGG	TG
ACGTTTCGCAGGCAAATAG	CC
GGGCTCGTGAAAAAAAGGC	TG
TATTGCTGTTGAATTGCTG	GC
CTTCGGCTCCGGCAGCAAT	GA
GGCAGGGCCGGAGAGAAGA	CC
TGCTGTTCAGGTCTGCGCC	TC
CGGCATCCACACCTTGTTC	AG
TAGAATGTCAGCAGGACAA	GA
TGCTGCTCCCATTCCCATT	GG
AGTGCTTCAACTAATATTC	GG
CTGGCGCTGGTGAACATAT	AT
AAACATGTGCCGAAACGAC	AG
TGTGCTGTGCAAATGCACC	AA
ATCACATCCAGCGGGATCC	CC
TAGCCAGTGCCTGATACTG	AG
TATTCGCTTGCCGTGTGGC	AG
CGTTTACCCACGGCACGCC	GG
TTCTTGCGCATCAGCACTA	TG
CGCCAGACCAGAACCGCCC	TG
GATTGCGCTTCAACCAGAC	GG
CTGGACAGGAGCGCGTTTT	AC
GAAGAAACCATTACTGCCG	GT
ATATGACAGTGCTGCTCCC	CA
GATAAAAACTCTCTTTGGG	TC
TTTCCTGGCCCAGAACCCA	CC
TACCAGTGGGGCATCGCGC	TA
CTGCCATCACATGGACTTG	CT
AAGATAGCTGTCGGTCATG	GG
ATTTCCAGATGGTGTTCGG	AT
GTTCACAATTGAGCGCCAA	TT
AGAATAAAAATCAGCTTTG	GC
ACCACCAGAAACTGGCGCA	CT
GGTCATTTGAGAGCATGAA	TC
TAAAAGCAGCGACAGATTG	GC
GTTTATCGCCCGGTCGGTA	CA
CGGTATTGAACAGCGCCAG	GT
CTGACTGGCTTTTTGTGCA	CC
CTTAACAAAAATATCGACG	CG
GCGGATCGAGATTGCCCAG	TG
CCATTACTGCCGTACCGGG	AT
GCCGCGCACGTTTCGCAGG	CC
TCGAGGGTTTGTCACCACT	TT
TGTTTAACCTGGGCCGCAT	CT
ATTTGAAATAGATCTGTTT	TG
GTTTCTACTGCCTGACTGG	TC
CCGCTAGTTGAGAAAACAG	GT
GGAAGAAACCATTACTGCC	TG
GAGTGCTTCAACTAATATT	TC
AGGCATTGCATTAACTCCT	GT
TCTGCACCTATGCGATAAA	TC
AGTTGCGCCGCGCACGTTT	TC
GCTCTCCTTGTTAATTTAA	TG
ATCCGCGGCGACTTTGGAA	CA
CCAATGCGTCAGTGCTGGC	GG
GTAGACCGTTTTCCACCAG	GA
AGCCGCGCTGAAAGAATGA	TA
GTGACTACGCCGGAGGTCT	TC
CTTGATAACTGCGCTATCG	TT
TGAAAAAAAGGCGTCATCA	GC
GGTGATGGCGCATCCCGGA	GT
CCAATCTTGATCATGATTT	GC
ATTCATTACGAACAAATAC	GC
ATAGGGAAACAGAAATTCC	TA
TCGTGCTCACGTCCGGGAA	TG
TGGTTGGGCCAATATGAAA	AC
ACTACGCCGCGCCCAGCGA	CG
ATTAGCTGCAAAACGAGGC	AA
CAGCCCTTGCAGGCAGGAA	CA
TTTCAATTGAGAGGCAGCG	GT
TGCGCGGACATATGACAGT	CG
TCCTTGAGATGGTAGCTGA	AA
TTGATTCATTACGAACAAA	GT
TTAACTCCTTAATTCCGCA	AA
ATGAACCGGAGAGCACTAC	CG
GGGGTGTAATCGCCATCCA	CC
CCGGTTTTCGAACATCCAG	TG
CACCGCTTTACAGCGCGGA	CT
CTGAATGCGGGGTGTAATC	GG
TCATGATTTCGCTCCCGGT	AA
TATCGGCAACCAGACCAAG	GA
TCGAAAGTAGAGCAGTATT	GT
CCACGTATGGTGTGAACGG	AA
CAGCTCTTCCATATTGTTG	CG
ATGAGGCTTAACGCCGGGG	AC
CGCATCCCGGATTCGGCCA	GG
AATTTCACCTGCGGTCAGA	CT
GAACCCGGCTTTTCGCGCT	CG
TTCACCGCAAACCACTGGG	TC
AACCATTACTGCCGTACCG	AG
GTAAGCGAGCCAGCTCTTG	TA
CATTAATATCTCCGGGAGC	GG
TGCGAAATCGCTCATGATA	TA
ACCACATGACGCATCCGGT	CT
TGGCGATATCCGTCGCGCC	CG
AGCGCATCAAGCACCGCGT	CA
CCCGGTAGAGTGATGCCAG	TA
CGCATTGACCACCAGCACC	CA
AGCGCCAGATGAAAGAGCA	CC
GAAAGTAGAGCAGTATTTG	CA
TGTTGAGGCCAATGGCAGC	CG
CTGCGCGGACATATGACAG	CT
TTGTTGCGATACAGCGCCA	AG
TTATCCAGTGCGTTTACCC	CA
ATTGTTGCGATACAGCGCC	GA
GATTCATTACGAACAAATA	TC
AATAATTTTTACGGTCGAA	GC
CTCTTGACGAACGGCATCC	GA
CCAGCGAGCGGACGCCCTG	CC
TTATTTTATGTGAACTAAG	GC
GGCTTTCACCGCAAACCAC	AT
GCGCTGAAAGAATGAACTG	CG
ACCACTTAACCATTCGCCA	CT
TCCTGGCCCAGAACCCACT	TC
GGACAGAATGAATGTGTCA	CC
TGCGCATCAGCACTAGCGA	TT
AGCGAGCGGACGCCCTGCT	CT
GCGGGCACGACGCCTGCCA	AT
TGGCAGCGGGAAGTGCAGG	AG
CGGATTGTTGCGATACAGC	GG
TCATCGGCGATAACGCCAA	AT
ACATTGTGTGTTATTTTAT	AG
GGTCGAACCTAGTCCCGGT	CT
ATGCATATTCCAGTGCCAG	AG
CTAGTCCCGGTTCTGCACC	CT
TAAATTCCCGTCAGGTAAA	GA
CGCCGCTAGTTGAGAAAAC	GA
AAGCACCGCGTAGCGGTAG	CC
TCGCCGTACTGTCGAAAGT	TA
ATTTACCGGGTGATGGCGC	GA
CCGCAATTTCACCTGCGGT	TC
CAGGCTCTGTGTGACTACG	CC
ACGGGCTGGTGCAATTTGA	CC
TGCGGATCGAGATTGCCCA	CG
AAGGGCGGATAATCCCCAT	GT
AGCGGTAGCAATTTCTTGC	GG
CACTGGACAGGAGCGCGTT	CT
TAGCTGCAAAACGAGGCAT	TT
GCCCGGTCGGTAATAAGGC	CA
CACCTGCCTCTTTCAACGT	GA
AAGTGCAGGGCTTTGGCTG	GT
GGAGAGCACTACGCCGCGC	CC
AGGCAATATCGCTACCGGA	AG
TGAGATGGTAGCTGAAAAA	TG
TAATATCTCCGGGAGCGGT	TA
CCTTAATTCCGCAATTTCA	TC
GCATCCCGGATTCGGCCAG	CC
AGTGCTGCTCCCATTCCCA	CT
GATAAACTTTTCCGGCAAC	CG
CTCTTGCTGTAAGCGAGCC	CA
GATGGTGTTCGGTCAGCGC	AA
AGCGCTGGAAGATAACGGT	AA
TTCCACAGCATCGAACCCG	AG
GTGAACTAAGCGTTAGTTG	TC
AAGGCTTCTCCCTGAATTT	CC
CCGAACCGGTTGCATAGCC	GG
AACGATACCGACATGAAAC	CT
TCTTGACGAACGGCATCCA	CC
CAGCACCTGTTTAACCTGG	AG
GTAGCAATTTCTTGCGCAT	GC
TTGGCTGTATCGGCAACCA	TG
TGATTTGCCAGTAAAAAAG	AC
TGCTGCTGTCCAGCCCTTG	TC
CCGGAGAGAAGACCGTAAA	GC
TGCTGTGCAAATGCACCAC	GC
ACCGGCAGGGCCGGAGAGA	GA
TACTGCCTGACTGGCTTTT	CT
CTGATCACCAGTGCGTCGA	GT
GGGATCCCCGCACGGGCTG	CC
CGATACAGCGCCAGATGAA	GA
ATTTAAGGGCGAGTGAGAC	GA
CGCTGCGGCGAAGCGTTCA	GA
ATGGACTTGTTCACAATTG	CA
CCGCTGCGGATCGAGATTG	GC
CATTACTGCCGTACCGGGT	CT
GGCATTGCTGTTCAGGTCT	AG
CGGCTTCCAGCACGGGTGC	AC
AGGACAAAGGAAGGAGCAA	CA
TTACCAGTGGGGCATCGCG	GC
CGGGCCAGGCCAATCGCCA	CG
TAAAAATCAGCTTTGCCGT	AT
ATTAAGGCATCGGTAACCG	CG
TGACCCTAAGCCAACGATA	TC
CACCACTTAACCATTCGCC	TA
AGAAATTCCACAGCATCGA	CA
TGTTAATTTAAGTGATATT	TT
CGAACAAATACCCCTGATA	AA
AATCCAGCCAGAGCGGTAG	GC
GCCAGACCAGAACCGCCCG	CT
CGGGCGGTCACCGAGAATA	TA
ACGTTGCTGCTGTCCAGCC	AC
AACCCGGCTTTTCGCGCTG	GC
ATATTGTTGGCGGCTTCTT	CG
CGTCGATTGCTTCCGGCAT	GT
GCGCAGGCATTGCTGTTCA	AG
GTCGACCATGTGCTGTGCA	CA
GTGATCTGATTCACATAAA	GT
GTGCAAATGCACCACCGCT	TT
CAAAGGCAATATCGCTACC	TG
CACATAAATTAACATTGTG	TT
AATCGCTCATGATAAAAAC	AT
TGGCTGTATCGGCAACCAG	TA
TTACGGTCGAACCTAGTCC	TC
CTTTTACTGCACCACCAGA	GA
GCTTTACAGCGCGGATTGT	CT
CGCCAGTAAATTCCCGTCA	TG
TACGAACAAATACCCCTGA	TT
AGTAGAGCAGTATTTGAAA	AT
GCAGTTGATTCATTACGAA	AC
CAACGCCTGTTTCACCAAA	GC
TGTTGTGCAACGCCTGTTT	AC
TTTGATATTGTGAATATAA	GG
TTTTGCTCCAGTTGCTTTT	GG
AGCGTAGAATGTCAGCAGG	TA
ATGGTTGGGCCAATATGAA	AA
ATTGCATTAACTCCTTAAT	CT
ACCTTTCGCCGTACTGTCG	TA
TATCTCCGGGAGCGGTATT	AG
CTCCAGTTGCTTTTGGATT	GT
TTGATCATGATTTCGCTCC	CC
TACCGTTGGTAGACCGTTT	GT
GTCTGCGTGTGCTTCGTGC	TT
GTAAATTCCCGTCAGGTAA	AA
ACCTGCCTCTTTCAACGTA	CG
ATTCAATGCTGTTGAGGCC	TA
TTCATCTGCTCTCCTTGTT	TA
GCGAAATCGCTCATGATAA	TA
GCAATATCGCTACCGGAGG	GC
TTCCCATTGACCCTAAGCC	AA
GATGGCGCATCCCGGATTC	TG
TGTCTGCGTGTGCTTCGTG	AC
AGCTTTGCCGTTTCCTCCA	CG
TAGCAATTTCTTGCGCATC	GA
TTGCGCATCAGCACTAGCG	CA
GCCAGGTCGATGTCTGCGT	TG
ATAACGCCAATCTTGATCA	GT
TGTGACTACGCCGGAGGTC	GT
GAGCCAGCTCTTGACGAAC	CG
GCGCCAGTGTCAGATGGTT	AT
ATATCGACGGCTGAATGCG	AG
ACGAACAAATACCCCTGAT	TA
GCAGCGGGAAGTGCAGGGC	GT
TCCAGCACGGGTGCCAGTC	TG
AATCTTGATAACTGCGCTA	AT
GTTTCAGATGTTGTGCAAC	GG
ACATGTGCCGAAACGACGC	AC
CCAGCGATTGCTGTGTGGC	GT
TGCCGAAACGACGCCGCAG	GC
GCTGTAAGCGAGCCAGCTC	TT
AAAAAAGCCTGATTGTCTG	TC
GGGGAAATGGTTGGGCCAA	CT
CAAAAGTTGATACCCGTAG	GA
ACCCCGCAAGCACCTGCCT	AC
GCATCGCGCAAGGCTTCTC	GC
TTAACCTGGGCCGCATTGA	TC
TGCCTCTTTCAACGTAGCG	CC
GTACTGTCGAAAGTAGAGC	CA
ATTGCTGTTCAGGTCTGCG	CC
GATCTGATTCACATAAATT	TA
CCTGATTGTCTGCTGCCAG	GT
TCACCTGCGGTCAGATAAC	TG
TTGAGAGCATGAACCGGAG	TA
TCGACGGCTGAATGCGGGG	AT
CAGCACCAGCAGTGCGTCC	CA
AAATTAACATTGTGTGTTA	TT
CAGTCGTTCAAAGGCAATA	CT
ACGGACAGAATGAATGTGT	AC
CGTTTTCTTGCGCCCACTG	CC
TCGGCAGCGTAGCGGATAT	GT
ACCAAACAGCACCTGTTTA	CA
CGGTCACCGAGAATAAAAA	GT
CGGTAGCAATTTCTTGCGC	GA
TTTGGCTGTATCGGCAACC	CA
GGCAAACGTCGCGGCGTTA	CT
TAAAAAAGCCTGATTGTCT	GG
CGGTAAAATCATCGGCGAT	CA
CGCGCAAGGCTTCTCCCTG	TA
GAGCACTACGCCGCGCCCA	AG
CTGGCAATCCGCGTCATCT	AC
CCTGTTTAACCTGGGCCGC	AA
TTGAGGCCAATGGCAGCGG	GG
CACCTCTTTCGAGGGTTTG	GT
GCGGTCAGATAACGGATCG	TG
GCATAAGCGGCCAGAGTTT	TC
GCAAGTACACTTTCCTGGC	AC
ACTGCCGTACCGGGTTTCA	TG
CAGATCGAATCCAGCCAGA	CG
GCACTTCGGTGAACATCAT	GG
TGCTTCCGGCATTTTACCT	TG
TTCCAGATCGAATCCAGCC	TA
GTGATATTTTGTTTGATAT	AT
TCGGCAAACGTCGCGGCGT	TT
TTTGGGCTCGTGAAAAAAA	CG
CAGAAAACTGGCGATATCC	CG
TATTTTATGTGAACTAAGC	TG
CATAAGCGGCCAGAGTTTC	GA
ATAAAAATCAGCTTTGCCG	AT
GCGCCGCGCACGTTTCGCA	TG
TTTTACTGCACCACCAGAA	CA
CAGGTAAAAGCAGCGACAG	TA
TGTTGGCGGCTTCTTGCAG	TG
CGGTCGGCAGCGTAGCGGA	GT
AAAACTGGCGATATCCGTC	GG
GTACACTTTCCTGGCCCAG	AA
CGTTGCTGCTGTCCAGCCC	AT
CGAACCGGTTGCATAGCCG	CC
CATGAAACTCAGATCCCGT	AT
GCGAGCCAGCTCTTGACGA	AA
GTGTGCATAAGCGGCCAGA	CG
GCAGGCAAATAGCGTAGAA	CT
ATCGCCATCCACCACATGA	AC
CAGTGCGTCGATTGCTTCC	CG
CAGCGCCAGTGTCAGATGG	AT
CAGCTCAGAGCCGCCAGCG	CA
TCAACCAGACGGGGAAGAT	TA
ACAGGAGCGCGTTTTCAGG	GC
CCTGGCGGTTGGTCATTTG	AA
GCGCATCCAGCATTTCCAG	GA
CGACGCCGCAGCGCCCTGT	AG
AGATCCTGTGCGATGCGTT	CT
TAGCGGCTTTTACTGCACC	TA
CAATATGTACGCCCGCTAA	GC
CGTGTCACGCCTTCCGCTG	GC
CGATTGCTTCCGGCATTTT	TA
GCGCAAGGCTTCTCCCTGA	CA
CGTGTGCTTCGTGCTCACG	GT
TAACAAAAATATCGACGGC	TT
GAGAGCATGAACCGGAGAG	TC
GCGAAGCGTTCAATAAAAG	GG
AACATTGTGTGTTATTTTA	TT
CTGTCGGTGTCGCCAGTAA	CA
GCCAGATCCTGTGCGATGC	CG
TTTCAGATGTTGTGCAACG	GC
CGCCCTGCTTTGCGAGCCT	AG
GTCATTTCACCGTTAGCGG	AC
ACGGCTTCCAGCACGGGTG	AC
TGGCGGCTTCTTGCAGGCT	TT
CACGACGCCTGCCATCACA	GT
AAATTAGCTGCAAAACGAG	TG
TTGGGCTCGTGAAAAAAAG	TG
TTGTGCAACGCCTGTTTCA	GC
GCTACCTGGCGGTTGGTCA	TT
TAACCTGGGCCGCATTGAC	TC
GAGCGTCGCCAAATCATCC	AT
CATTGGTCACGACGTCATA	GC
TGCCTGATACTGGCTGGAG	GA
ACTTTGGAAAGCCGCTGCG	GG
TAGGGAAACAGAAATTCCA	AC
ACGGCATCCACACCTTGTT	AC
TCACATCCAGCGGGATCCC	AC
TAAACGGCGTGTCGAGAGC	GA
GGACTTGTTCACAATTGAG	TC
AGTGCTGGCGGTGGCAAAA	CA
AGGCAGCGTGCCACATCAA	GC
CGGTAACCGGGCCAATATT	TA
GCGATTGCTGTGTGGCTTC	AA
GGCTTTTACTGCACCACCA	CG
CTAAGCGTTAGTTGCGCCG	AC
CCTTGAGATGGTAGCTGAA	TA
AAAAAGGCGTCATCACCGA	AA
GCAAAAGTTGATACCCGTA	AG
CACTTTCCTGGCCCAGAAC	AC
ATGATTTCGCTCCCGGTAG	CA
ACCGCCCGTTACCAGTGGG	AG
CCGGGCCAGGCCAATCGCC	GA
GCGAGCCTGGTTACCGTTT	TT
GCATCACCACGTATGGTGT	CG
TTCCTCCAGCTCTTCCATA	TT
TCCACCACATGACGCATCC	AG
ATTATCGATAAATACTGCC	TC
CCGTTACCAGTGGGGCATC	CG
CCGTATTGCTGTTGAATTG	AC
AGCGCCAGTGTCAGATGGT	CT
GGCCAGAGTTTCAATTGAG	CA
CGGACGCCCTGCTTTGCGA	GG
GCGCTGGTGAACATATTCA	GA
ACCGTATTGCTGTTGAATT	CG
CCTTGTTCGAAAACATGTG	AC
GAAACTCAGATCCCGTTTT	TC
GACTGGCTTTTTGTGCACC	TG
TTGAGATGGTAGCTGAAAA	CA
CGCGTAGCGGTAGCCCTCT	CT
ATGGGATTTACCGGGTGAT	CG
TTGCATAGCCGCGCTGAAA	GG
CAGCGATTGCTGTGTGGCT	CT
TGCTCTCCTTGTTAATTTA	CA
GCCAGAGTTTCAATTGAGA	GG
GGCGCATCCCGGATTCGGC	TC
CGTTTCGCAGGCAAATAGC	AG
GAACAAATACCCCTGATAA	CA
CTTCACGGGCTGGTGCAAT	AT
AGCCAGAGCGGTAGCAATT	CT
CAAAACGAGGCATTGCATT	GA
AAATCATCCTTGAGATGGT	CA
AACTTTTCCGGCAACGGCT	AT
ACGGCTGAATGCGGGGTGT	GA
GCATCCGGTTTTCGAACAT	CC
CTGCACCACCAGAAACTGG	AC
TGTGCATAAGCGGCCAGAG	GT
TAGTCCCGGTTCTGCACCT	CA
CTTGCAGGCTTTCACCGCA	TA
AACGTTGCTGCTGTCCAGC	TC
AAGGAGCAAAAGTTGATAC	GC
CGCAAGCACCTGCCTCTTT	CC
AAGTTGATACCCGTAGAGC	AG
CAGTAAATTCCCGTCAGGT	CA
CCGTTAGCGGCTTTTACTG	AC
AAGTTGCCAGATTTAAGGG	GC
ACGCCCGCTAACAACTGGT	TG
TGTGAATATAAGCGCTGGA	TA
ATCAAGCACCGCGTAGCGG	CT
TGTGCTACCTGGCGGTTGG	AT
CCCTCTTGCTGTAAGCGAG	GC
CATCCAGGAATTTCCGGCG	AG
AACCCACTCTGCCAGTTCG	GT
AGTGTTTCTACTGCCTGAC	CT
GCCGGAGAGAAGACCGTAA	GA
ATGTGCCGAAACGACGCCG	CC
ACTCCTTAATTCCGCAATT	AT
TCCAGCCAGAGCGGTAGCA	AA
CGTGTGCATAAGCGGCCAG	TA
CTTCTTGCAGGCTTTCACC	GG
CACCGAAGTTGCCAGATTT	TA
GCGACAGATTGCCAGCCGA	AA
GGCGATAACGCCAATCTTG	CA
GAGAAAACAGTGTTTCTAC	TT
GTAGAGCGTCGCCAAATCA	CT
CAGATTTAAGGGCGAGTGA	CG
AGGAAAGCGCCGTCGACCA	CT
ACCTCTTTCGAGGGTTTGT	CC
CATGATTTCGCTCCCGGTA	TG
TGCTGGCGGTGGCAAAAAC	GC
CGTTTATCGCCCGGTCGGT	GA
CGTCCAGTTTTTCGGCAAA	GC
GCGACTTTGGAAAGCCGCT	GG
TCCCGTAACCCGCGTTACT	TG
CAGTATTTGAAATAGATCT	GG
TGAGTGCTTCAACTAATAT	CT
TTTACCTGTTGGAACACCG	TT
ACAGTGTTTCTACTGCCTG	AA
CGGATAATCCCCATTCCCC	GC
CAGCGGGCACGACGCCTGC	CC
GGTAATGTGCTACCTGGCG	CG
AGTGAGACAGGCTTATCCA	GG
CTGCTAACCGCGCCGCTAG	GT
TGGAGCAAGTACACTTTCC	GT
TTTGACGGTAATGTGCTAC	AC
GTGGAGTAGTTATAGGGAA	GA
TTGTGCACCGTATTGCTGT	TT
GCAGCGACAGATTGCCAGC	AC
GTAGAGTGATGCCAGAGAA	GA
TTCGCTTGCCGTGTGGCGC	AA
GTTCAGCATCTTCGCCAGC	CG
TCAGCGCATCAAGCACCGC	GG
TTTCTTGCGCATCAGCACT	AA
TCCTTAATTCCGCAATTTC	CA
TCACCGCCTGCGACAATAA	CA
CTTGAGATGGTAGCTGAAA	CA
ACGACGCCGCAGCGCCCTG	AT
TGGCTTCAACCACTGGACA	GG
ACGCCTTCCGCTGCTAACC	CG
TTGTCACCACTTAACCATT	TC
CATATTCCAGTGCCAGGTC	GG
GTATGGTGTGAACGGACGA	CA
TGCTGTTGAATTGCTGCCA	TA
TTTTTACGGTCGAACCTAG	AT
CCTGCGGTCAGATAACGGA	AT
TGGTCACGACGTCATACAT	TC
ATCGAATCCAGCCAGAGCG	GG
GCTGATCACCAGTGCGTCG	GA
GATGGTAGCTGAAAAAGGC	AA
TTGCGAGCCTGGTTACCGT	TT
AGCGGCCAGAGTTTCAATT	AG
TTTAACCTGGGCCGCATTG	GA
GACAAAGGAAGGAGCAAAA	GG
TTTCACCTGCGGTCAGATA	AA
AGGTCTCACCGCCTGCGAC	GA
CGGTAGCCCTCTTGCTGTA	GA
ACGAACGGCATCCACACCT	GT
CGCAGCGCCCTGTGGATTG	CC
ACCGGGTTTCAGATGTTGT	TG
CATCGAACCCGGCTTTTCG	GC
CCATTAAGGCATCGGTAAC	TC
ACGCCGCAGCGCCCTGTGG	GA
GGCTGGAGAAGAGATAATG	TA
CATACATCACATCCAGCGG	TG
TGTTCAGGTCTGCGCCCCA	CG
AAACGAGGCATTGCATTAA	AC
ATAAATACTGCCCGGTACC	GG
ACATCAACTTCACGGGCTG	CG
GTGTCACGCCTTCCGCTGC	CT
ACGAATAACGTTGCTGCTG	GT
TTCAACCACTGGACAGGAG	CC
ATTCACATAAATTAACATT	GG
AATATTCGCTTGCCGTGTG	TG
CCGCTGCTAACCGCGCCGC	TT
GCTCTACTTTTGCGAAATC	TG
CGTCGCCAAATCATCCTTG	GA
GGCCAGCAGTTGATTCATT	CA
ACATGACGCATCCGGTTTT	CC
GTTATAGGGAAACAGAAAT	AT
CTTTCGCCGTACTGTCGAA	CA
TCAGCTTTGCCGTTTCCTC	AC
ATAAAGCGTGTCACGCCTT	AC
AGAAAATCTTGATAACTGC	GG
GCCTGATACTGGCTGGAGA	TA
CTGCTCTACTTTTGCGAAA	AT
TAAGCGAGCCAGCTCTTGA	GC
CTTGACGAACGGCATCCAC	TA
GTTTACCCACGGCACGCCG	CG
AGCAGTTGATTCATTACGA	CA
CAGCGCCCTGTGGATTGCG	GC
GTGCTGTGCAAATGCACCA	TC
GAGGTCTCACCGCCTGCGA	GC
CCTTGCAGGCAGGAAAGCG	CC
GTTGATTCATTACGAACAA	AA
TATTCCAGTGCCAGGTCGA	AT
ATGACAGTGCTGCTCCCAT	TT
CATGGATAAATTAGCTGCA	TA
GACCGTAAACGGCGTGTCG	AA
CCGCGTTACTGGCGCTGGT	CG
CGCGCCGGTAAAATCATCG	TG
TGTTCGGTCAGCGCATCAA	GG
CGGGCTGGTGCAATTTGAC	AG
TGCATATTCCAGTGCCAGG	AT
GTCATCACCGAAGTTGCCA	CG
CGTAGAGCGTCGCCAAATC	CA
GGATTGCGCTTCAACCAGA	TC
GCCACATCAACTTCACGGG	TC
CTGCACCTATGCGATAAAC	TT
TTTATTCCCAGGCTCTGTG	TT
ATAACGGTATGGTGATCTG	GA
AGGCTTATCCAGTGCGTTT	CA
GGCTGAATGCGGGGTGTAA	CT
CTTCGCCAGCGGGCACGAC	TG
AGGCTGATCACCAGTGCGT	CC
CGTGCTCACGTCCGGGAAG	TG
GCAGGCATTGCTGTTCAGG	CT
CGCGGCGACTTTGGAAAGC	CC
TGCCAGTCGTTCAAAGGCA	GA
ATTCCCCCGCATTAATATC	CT
CAGGCATTGCTGTTCAGGT	GC
CGCCGGAGGTCTCACCGCC	AT
GAATAACGTTGCTGCTGTC	CC
CAAATCATCCTTGAGATGG	CT
CCGAGAATAAAAATCAGCT	AT
GATAGCTGTCGGTCATGGG	AA
CCAGAGTTTCAATTGAGAG	GG
AAGCGTTAGTTGCGCCGCG	TC
ATCCCCGCACGGGCTGCAA	GG
ATAGCTGTCGGTCATGGGA	GT
CCGTTTCCTCCAGCTCTTC	GC
CGCGCCCAGCGAGCGGACG	CC
CGTCCGTTGACCGGCAGGG	AC
ACTGGCGATATCCGTCGCG	AC
GCTTCCAGCACGGGTGCCA	GG
CCCACTCTGCCAGTTCGTG	AT
CCTGCCATCACATGGACTT	GG
CGTAACCCGCGTTACTGGC	CG
CTATGCGATAAACTTTTCC	CG
CCAGGTAGAAAGACCTGCG	CC
AGAGCACCTCTTTCGAGGG	AT
CCTGCTTTGCGAGCCTGGT	CT
CAATCGCCAGACCAGAACC	CG
CCATCCGCATCACCACGTA	CT
CAGAAACTGGCGCATCCAG	CC
GAGCCGCCAGCGATTGCTG	AT
ATCCAGCATTTCCAGATCG	CA
TTCGAGGGTTTGTCACCAC	TT
TGCGGCGAAGCGTTCAATA	CA
ACGGTAATGTGCTACCTGG	GC
TGTGCGATGCGTTTATCGC	CC
AGTATTGCTGAACTAACGG	CA
GTGCCAGGTCGATGTCTGC	AG
CACCAGCGGGACATTTCCC	GA
ATATTCGCTTGCCGTGTGG	AC
AGGCATGAACCTGTCGGTG	CT
TGGCGGTTGGTCATTTGAG	CA
GATCATGATTTCGCTCCCG	TG
AACAACTGGTGAATAATTT	TT
TCACGCCTTCCGCTGCTAA	GC
GAGCATGAACCGGAGAGCA	AC
AAGGCATTGTCAGTATTGC	AT
TGAAATAGATCTGTTTGCA	TA
CTGCGACAATAAAGCGTGT	CC
ATCCAGGAATTTCCGGCGG	CC
GCTGCTGTCCAGCCCTTGC	TA
AGGCTTTCACCGCAAACCA	CC
GATCCTGTGCGATGCGTTT	AA
AACTGGCAATCCGCGTCAT	GC
TGGCCCAGAACCCACTCTG	CC
GGATCCCCGCACGGGCTGC	GA
CGTCGCGCCGGTAAAATCA	CT
AATCGCCATCCACCACATG	TA
AAAATCAGCTTTGCCGTTT	AC
ATAACGGATCGGGCGGTCA	GC
CAAACCACTGGGCCATGAT	GT
TTGCCGTTTCCTCCAGCTC	TT
GCAACGCCTGTTTCACCAA	TA
CGTTATCAGAAACCCCGCA	GA
CATGACAGTCATTTCACCG	CT
TGCAGGGTGGAGTAGTTAT	TA
CGCTAACAACTGGTGAATA	CA
CCGGGAAGGGCGGATAATC	TC
ATGATAAAAACTCTCTTTG	CG
TGTCCAGCCCTTGCAGGCA	CG
GCGGTGGCAAAAACCAGTG	GG
CGCGGCGTTATCAGAAACC	TC
TCTTGCGCCCACTGCCGGG	TC
CTAACCGCGCCGCTAGTTG	GA
GGGGCTGAGTGCTTCAACT	CA
CAGTATTGCTGAACTAACG	TG
AGCGCAGGCATTGCTGTTC	TA
CACCGCGTAGCGGTAGCCC	GT
TTTACCCACGGCACGCCGG	GG
TGCCGTACCGGGTTTCAGA	CT
CTTTCCTGGCCCAGAACCC	AA
CCGGCAGCAATATGTACGC	TC
TACCTTTCGCCGTACTGTC	TG
TCTCCGGGAGCGGTATTGA	AA
GCATTTTACCTGTTGGAAC	GA
CACCGTTAGCGGCTTTTAC	TT
TGATACTGGCTGGAGAAGA	CG
AGCCGCCAGCGATTGCTGT	GG
AATTTAAGTGATATTTTGT	TT
AGCCTGATTGTCTGCTGCC	AA
CAGAATGAATGTGTCACAT	AA
GAGCAAGTACACTTTCCTG	GG
CATCCACACCTTGTTCGAA	GA
GAAACAGAAATTCCACAGC	GA
GACAGATTGCCAGCCGAAC	CC
CTGTCGGTCATGGGATTTA	GC
CGCCAGTGTCAGATGGTTT	GT
GAGGCATTGCATTAACTCC	CT
AAAGCAGCGACAGATTGCC	AA
TTCAATTGAGAGGCAGCGT	TG
CCGTCAGGTAAAAGCAGCG	CA
AAGCAGCGACAGATTGCCA	AG
ACCGTTAATTTGTACCGTT	CG
GGTACCGTTCAGCATCTTC	CG
CACCAGCACCAGCAGTGCG	CT
TTTTACGGTCGAACCTAGT	TC
CCCTTGCAGGCAGGAAAGC	GG
TTTCCACCAGAAAACTGGC	TG
GGCGACTTTGGAAAGCCGC	CT
CATTGACCCTAAGCCAACG	CA
GCAGCGCCCTGTGGATTGC	CG
TAACCATTCGCCATCCGCG	TG
CGGCAACCAGACCAAGATC	TC
AAACGGCGTGTCGAGAGCA	TT
TGGTGATCTGATTCACATA	AA
AACCGTACGTCCGTTGACC	AG
ACAATTGAGCGCCAATGCA	CT
ACCTGCGGTCAGATAACGG	CA
ATGTGCTACCTGGCGGTTG	AG
TCACGGGCTGGTGCAATTT	TG
CGAACCTAGTCCCGGTTCT	TG
AGACCGTTTTCCACCAGAA	TA
TCCCGTTTTCATCTGCTCT	AC
CAGCACGGGTGCCAGTCGT	CT
GGTAGCAATTTCTTGCGCA	CT
AAGGCATCGGTAACCGGGC	TC
CAGCGACAGATTGCCAGCC	GG
ATTGAGCGCCAATGCATAT	AT
GCCGGAGGTCTCACCGCCT	CG
GACGAATAACGTTGCTGCT	GG
CTCTTTCGAGGGTTTGTCA	CC
CACGTCCGGGAAGGGCGGA	TT
ATTTTATGTGAACTAAGCG	TT
GAATAAAAATCAGCTTTGC	AC
TTCTTGCGCCCACTGCCGG	TG
CTTGCGCATCAGCACTAGC	TG
GCAATTTGACGGTAATGTG	TC
AATGCACCACCGCTTTACA	AG
AAGGCAATATCGCTACCGG	AA
CCAGTGTCAGATGGTTTTG	GC
TTGTGAATATAAGCGCTGG	AA
GCGAGTGAGACAGGCTTAT	GC
TTTCAACGTAGCGCAGGCA	CT
GTGGAAGAAACCATTACTG	AC
GCGAGCGGACGCCCTGCTT	AT
CTGTAAGCGAGCCAGCTCT	GT
GAATGTGTCACATATGACC	TA
CACCGAGAATAAAAATCAG	TC
CCAGACCAAGATCCTTAAC	AA
AGGCATTGCTGTTCAGGTC	CT
AGACCAAGATCCTTAACAA	CA
CTTCTCCCTGAATTTCCAG	GA
GCGATAGTGGAAGAAACCA	AT
CATTGTCAGTATTGCTGAA	GC
CCCGCAAGCACCTGCCTCT	CT
GATGAAAGAGCACCTCTTT	AC
TTCGCCATCCGCGGCGACT	AT
ACTGCTCTACTTTTGCGAA	GA
ACCATGTGCTGTGCAAATG	GC
CAGGGTGGAGTAGTTATAG	GG
CACCAGAAAACTGGCGATA	CT
TGTTTCACCAAACAGCACC	CT
AGAGCGTCGCCAAATCATC	TC
GACAATAAAGCGTGTCACG	CC
AAAGCGTGTCACGCCTTCC	TG
AAGCCAACGATACCGACAT	TG
ATGTTGTGCAACGCCTGTT	GT
CCCCTGATAAACCGTACGT	AC
AAGCGCTGGAAGATAACGG	TT
CTTTTCCGGCAACGGCTTC	AC
GGCGGTTGGTCATTTGAGA	TG
ACCGGAGGCCATGACAGTC	TA
CATGAACCTGTCGGTGTCG	GC
GTTGCGCCGCGCACGTTTC	AG
CTTTGCGAGCCTGGTTACC	GG
CAGGACAAAGGAAGGAGCA	GA
ATCCGCATCACCACGTATG	CG
CTTGCAGGCAGGAAAGCGC	CC
TTAATTTAAGTGATATTTT	GG
TGACGCATCCGGTTTTCGA	AA
AGGTCTGCGCCCCAGGTAG	CA
CACGGGCTGGTGCAATTTG	TA
AAGCGGTCGGCAGCGTAGC	AG
GCTTTGCCGTTTCCTCCAG	AC
GTTGGTCATTTGAGAGCAT	GG
CGTCAGGTAAAAGCAGCGA	CC
GTAGAATGTCAGCAGGACA	CA
AGAGCACTACGCCGCGCCC	GA
GCCTGGTTACCGTTTTCTT	AG
TTGCAACCTTGCTGTTGCA	TA
AACCGGGCCAATATTACCT	TT
TTGCTGTTGAATTGCTGCC	AA
AAAGCCGCTGCGGATCGAG	GA
AACGGACAGAATGAATGTG	TT
ACTGCCTGACTGGCTTTTT	TG
CTGCCAGTTCCGCCAGATC	GC
AAATCGCTCATGATAAAAA	GC
TTTTCTTGCGCCCACTGCC	GG
GTCTCACCGCCTGCGACAA	GT
TTCAGATGTTGTGCAACGC	TC
CGGGCTGCAAGTGCCATCG	AC
GTCAGGTAAAAGCAGCGAC	CA
GAACACCGTTAATTTGTAC	GC
ATGAAACTCAGATCCCGTT	CT
GGAGCGCGTTTTCAGGCTG	AA
CATTCGCCATCCGCGGCGA	CC
TGTGCACCGTATTGCTGTT	TG
AATGGCAGCGGGAAGTGCA	CG
CAACGTAGCGCAGGCATTG	TC
TGGCGGTGGCAAAAACCAG	CT
AATCCCCATTCCCCCGCAT	TT
TCAGTATTGCTGAACTAAC	GG
GCGCAAAGCGGTCGGCAGC	GG
TTGTTTGATATTGTGAATA	TT
GTGCCTGATACTGGCTGGA	AG
TCCAGGAATTTCCGGCGGC	AA
AACGGTATGGTGATCTGAT	TT
CCGGCAGGGCCGGAGAGAA	AG
GCAAATAGCGTAGAATGTC	GA
CCGTTGGTAGACCGTTTTC	AC
TTACCGGGTGATGGCGCAT	TC
GATCGAATCCAGCCAGAGC	AG
TGATAAACCGTACGTCCGT	CT
AGCGGGAAGTGCAGGGCTT	CT
TTACCTGTTGGAACACCGT	TT
GAACATATTCAATGCTGTT	TG
CAGCAGGACAAAGGAAGGA	TG
GTTATTTTATGTGAACTAA	TG
CCGAAGTTGCCAGATTTAA	AG
AGCACTAGCGATAGTGGAA	CG
TCACCGAAGTTGCCAGATT	AT
CAGGTCGATGTCTGCGTGT	CG
CGGGTGCCAGTCGTTCAAA	AG
AGTGATATTTTGTTTGATA	AT
GTAGCCCTCTTGCTGTAAG	GC
AACGTAGCGCAGGCATTGC	CT
CCAAATCATCCTTGAGATG	GG
GCTGTTGAGGCCAATGGCA	TG
GGGTGCCAGTCGTTCAAAG	CG
GATCCCCGCACGGGCTGCA	GA
TGCTGTCCAGCCCTTGCAG	CG
GGCAGCGGGAAGTGCAGGG	TC
TTGTTAATTTAAGTGATAT	CT
TCAGCACTAGCGATAGTGG	AA
TTGCGCCCACTGCCGGGCC	CA
ATTAACATTGTGTGTTATT	AT
GGTAGCCCTCTTGCTGTAA	CG
ACTGGTGAATAATTTTTAC	AG
GCCAGTTCGTGTGCATAAG	TC
AGTTCGTGTGCATAAGCGG	CC
GCGCCGGTAAAATCATCGG	CC
AACGGCTTCCAGCACGGGT	CG
GAGATTGCCCAGGCATGAA	CC
GATCCTTAACAAAAATATC	AG
TCGTGAAAAAAAGGCGTCA	CT
GAAATCGCTCATGATAAAA	CA
CGAAGTTGCCAGATTTAAG	CG
CCAGGCATGAACCTGTCGG	CT
ACGCCGGAGGTCTCACCGC	TC
CAACCAGACCAAGATCCTT	GA
CGTAGAATGTCAGCAGGAC	GA
GTGAATAATTTTTACGGTC	GG
GATCCCGTTTTCATCTGCT	AC
CGGGAGCGGTATTGAACAG	CC
TTTACGGTCGAACCTAGTC	TC
ACATAAATTAACATTGTGT	CG
AAAATCTTGATAACTGCGC	GT
CTGTATCGGCAACCAGACC	GA
ACTTTTGCGAAATCGCTCA	TT
ACCGTTAGCGGCTTTTACT	CG
AAACTCTCTTTGGGCTCGT	AG
AACAGCGCCAGTGTCAGAT	GG
AGCATCGAACCCGGCTTTT	CC
GCTTCAACTAATATTCGCT	TT
GGTGAACATCATGGATAAA	CT
GAATGCGGGGTGTAATCGC	TC
GTCGAAAGTAGAGCAGTAT	TT
GCTTCAACCAGACGGGGAA	CG
GACCCTAAGCCAACGATAC	TC
TAATATTCGCTTGCCGTGT	CG
TACCCCTGATAAACCGTAC	AG
ACGACGTCATACATCACAT	CC
GGTGTCGCCAGTAAATTCC	CC
GCGCTGCGGCGAAGCGTTC	CA
AGAAACCCCGCAAGCACCT	CG
TCGAACATCCAGGAATTTC	TC
TAATTTGTACCGTTGGTAG	TA
CCGTTCAGCATCTTCGCCA	AG
GTGCGTCCAGTTTTTCGGC	AA
GCCAGTCGTTCAAAGGCAA	TT
CCAGATTTAAGGGCGAGTG	GA
ACAACTGGTGAATAATTTT	AT
TTTGTTTGATATTGTGAAT	TA
AACGCCAATCTTGATCATG	TA
TTGGCGGCTTCTTGCAGGC	GT
GAGCGGACGCCCTGCTTTG	CC
TGTACGCCCGCTAACAACT	AG
AGTTTTTCGGCAAACGTCG	CC
CGGCTGAATGCGGGGTGTA	AA
GCTCATGATAAAAACTCTC	CT
CGCCGTACTGTCGAAAGTA	TG
CGCTTTACAGCGCGGATTG	CT
GGCCAGGCCAATCGCCAGA	GC
CATATGACAGTGCTGCTCC	AC
TCGCGGCGTTATCAGAAAC	GC
CCCGGTACCGTTCAGCATC	GT
TACCGGAGGCCATGACAGT	CC
TGCTCTACTTTTGCGAAAT	CC
TGGTGAACATATTCAATGC	CT
CGATAAACTTTTCCGGCAA	GC
CAGTGCCTGATACTGGCTG	CG
GCCGAAACGACGCCGCAGC	TG
ATCCTTGAGATGGTAGCTG	CA
AATCGCCAGACCAGAACCG	CC
CATCCATTAAGGCATCGGT	GA
GCTGCCAATGCGTCAGTGC	TT
GGCTTTTCGCGCTGCGGCG	CA
GGGCCATGATTTGCCAGTA	TA
TAAACTTTTCCGGCAACGG	AC
GCGGTATTGAACAGCGCCA	AG
TACGTCCGTTGACCGGCAG	GG
AGCATGAACCGGAGAGCAC	GT
CCCTTTTATTCCCAGGCTC	AT
AATATGTACGCCCGCTAAC	CA
GAATTTCCGGCGGCATTGG	GT
GACCGGCAGGGCCGGAGAG	TA
GCATTTCCAGATCGAATCC	AA
ACCTGTTGGAACACCGTTA	TA
GAACATCCAGGAATTTCCG	CG
TGCTGTGTGGCTTCAACCA	TC
CAGTCATTTCACCGTTAGC	AG
TTTGAAATAGATCTGTTTG	AC
TTCGAACATCCAGGAATTT	TC
CCAGTTGCTTTTGGATTTG	TC
ACGTCCGGGAAGGGCGGAT	CA
GCATAGCCGCGCTGAAAGA	TA
TGATTGTCTGCTGCCAGTT	CC
CTGCGGCGAAGCGTTCAAT	GA
GCCATCGCTTCGGCTCCGG	TC
CCGGCTTTTCGCGCTGCGG	CC
TAATGAGGCTTAACGCCGG	AG
TTTACTGCACCACCAGAAA	TC
GCTGGAGAAGAGATAATGA	GG
GGCAATATCGCTACCGGAG	AG
AGAAAACTGGCGATATCCG	CT
AGAGCGGTAGCAATTTCTT	CG
TAGCGGATATTATCGATAA	GA
TGTTCACAATTGAGCGCCA	TA
TCGAAAACATGTGCCGAAA	TC
TCACCAAACAGCACCTGTT	TT
GCATCAGCACTAGCGATAG	CT
CCGGAGGTCTCACCGCCTG	GC
TCAGAAACCCCGCAAGCAC	AC
ATTTGCCAGTAAAAAAGCC	GT
CGTGCCACATCAACTTCAC	GG
TTTATGTGAACTAAGCGTT	TA
AGCGTCGCCAAATCATCCT	GT
TTCCTGGCCCAGAACCCAC	TT
CGTCAGTGCTGGCGGTGGC	GA
CGAGATTGCCCAGGCATGA	TA
GTAAAAGCAGCGACAGATT	GG
CGTAAACGGCGTGTCGAGA	CG
AAACTTTTCCGGCAACGGC	TT
CGACATGAAACTCAGATCC	CC
TCCAGTGCGTTTACCCACG	AG
GGATATTATCGATAAATAC	CT
GAAAGACCTGCGCGGACAT	AA
TACGGTCGAACCTAGTCCC	TG
AATTCCGCAATTTCACCTG	TC
TACGCCGGAGGTCTCACCG	CC
CAATCCGCGTCATCTCCTC	GT
ATTGAGAGGCAGCGTGCCA	AC
CGGCGTGTCGAGAGCATCC	AA
AGATTTAAGGGCGAGTGAG	CA
CGCCAATGCATATTCCAGT	GG
TGGCTGGAGAAGAGATAAT	CG
TCCGTCGCGCCGGTAAAAT	AC
CTTCCAGCACGGGTGCCAG	GT
GGGAAACAGAAATTCCACA	AG
CGACGTCATACATCACATC	AC
GGACATTTCCCATCCGCAT	GC
GTCTTCTTTCCCGTAACCC	CG
TCGCCAGCGGGCACGACGC	TC
CAGCGGGAAGTGCAGGGCT	GT
ACCGTACGTCCGTTGACCG	AG
CCAGACGGGGAAGATAGCT	AG
AGTTATAGGGAAACAGAAA	TT
GGCTGGTGCAATTTGACGG	GT
TTTTATGTGAACTAAGCGT	AT
GGGTGGAGTAGTTATAGGG	AA
GATACCGACATGAAACTCA	CG
AGTAAATTCCCGTCAGGTA	CA
TAACGGATCGGGCGGTCAC	AC
TCATGATAAAAACTCTCTT	CT
ACGATACCGACATGAAACT	AC
GACTTGTTCACAATTGAGC	GG
CACGTTTCGCAGGCAAATA	GG
CCACCGCTTTACAGCGCGG	AA
CGAGCCAGCTCTTGACGAA	GC
TCGGTAATAAGGCACCAGC	GG
CAATTGAGCGCCAATGCAT	AA
AACAGTGTTTCTACTGCCT	AG
AGCGCGTTTTCAGGCTGAT	GC
GTGGAGCAAGTACACTTTC	AC
CTTTACAGCGCGGATTGTT	GG
ATCTCCGGGAGCGGTATTG	TA
CGTAGCGCAGGCATTGCTG	AT
AATGGTTGGGCCAATATGA	AA
GCACCGCGTAGCGGTAGCC	AC
AACACCGTTAATTTGTACC	GG
GGTTTTCGAACATCCAGGA	CA
AACTAATATTCGCTTGCCG	CT
TCTTTCCCGTAACCCGCGT	TT
ACCGTTGGTAGACCGTTTT	TC
TAGAGTGATGCCAGAGAAA	GA
ACTTTTCCGGCAACGGCTT	AC
CTACGCCGGAGGTCTCACC	AG
TTCACGGGCTGGTGCAATT	CT
GCGGTAGCAATTTCTTGCG	AC
CACGCCTTCCGCTGCTAAC	TC
ATTGAACAGCGCCAGTGTC	TA
CGGCATTGGTCACGACGTC	GA
CAGGAGCGCGTTTTCAGGC	AT
GATTGCTGTGTGGCTTCAA	CC
TGCATAAGCGGCCAGAGTT	GT
TAAGGCATCGGTAACCGGG	TC
AGTGTCAGATGGTTTTGCT	CC
ATCCGCGTCATCTCCTCTC	AG
CCAGCCCTTGCAGGCAGGA	TA
CAGATGGTGTTCGGTCAGC	CG
GTCGGTAATAAGGCACCAG	GC
CAGGCATGAACCTGTCGGT	CG
ACAGTCATTTCACCGTTAG	GC
TAACGCCAATCTTGATCAT	AG
AACCTGGGCCGCATTGACC	TA
GCCAATCTTGATCATGATT	CT
GTAAAATCATCGGCGATAA	GC
GACTACGCCGGAGGTCTCA	TC
CGGGGAAGATAGCTGTCGG	AT
GCGATGCGTTTATCGCCCG	TG
TTCCGCAATTTCACCTGCG	AG
CATGATAAAAACTCTCTTT	TG
CCCGCACGGGCTGCAAGTG	CC
AGCGGACGCCCTGCTTTGC	GG
CGCCAGCGGGCACGACGCC	TT
TCCGCAATTTCACCTGCGG	TT
GGGATTTACCGGGTGATGG	TC
GCGCCCTGTGGATTGCGCT	AT
CGTTCAGCATCTTCGCCAG	CC
GCTACCGGAGGCCATGACA	CG
TTGGAACACCGTTAATTTG	GT
ACCAGACCAAGATCCTTAA	AC
TGGGATTTACCGGGTGATG	AG
CACCAGTGCGTCGATTGCT	TT
CGGCAACGGCTTCCAGCAC	CG
ACCGGAGAGCACTACGCCG	AC
CAGGCTTTCACCGCAAACC	GA
TATCCAGTGCGTTTACCCA	TC
AAGATAACGGTATGGTGAT	GC
AGATGTTGTGCAACGCCTG	CT
GCATCGGTAACCGGGCCAA	GT
CCGTTTTCTTGCGCCCACT	AG
TAGTGGAAGAAACCATTAC	AT
AAAGGCAATATCGCTACCG	CG
AATAAAGCGTGTCACGCCT	CT
AAAAAAAGGCGTCATCACC	GG
GGCATCGCGCAAGGCTTCT	GC
CATTGCTGTTCAGGTCTGC	GG
TTCCCATCCGCATCACCAC	TG
ATCGCTCATGATAAAAACT	AC
ACTCTGCCAGTTCGTGTGC	CA
AGATAGCTGTCGGTCATGG	AG
TCAGATCCCGTTTTCATCT	CG
TTGACGGTAATGTGCTACC	TT
ATTGTTGGCGGCTTCTTGC	TA
ATATCTCCGGGAGCGGTAT	AT
AACTCTCTTTGGGCTCGTG	AA
CGTTCAAAGGCAATATCGC	TT
CACGACGTCATACATCACA	TT
CGCGTCATCTCCTCTCGCA	CA
GAGAGGCAGCGTGCCACAT	TC
TTCAATAAAAGGCACTTCG	GG
GGTTGGTCATTTGAGAGCA	CT
CGTTTTCAGGCTGATCACC	GA
AATTGCTGCCAATGCGTCA	GG
GTTGATACCCGTAGAGCGT	AC
GCCCGCTAACAACTGGTGA	CA
CCTTAACAAAAATATCGAC	TG
AACAGAAATTCCACAGCAT	AC
ATTCCCATTGACCCTAAGC	CC
TTGCAACCAGCTCAGAGCC	GG
GCGATACAGCGCCAGATGA	TA
TTGCAGGGTGGAGTAGTTA	TT
TCGTGTGCATAAGCGGCCA	TG
TCCAGCCCTTGCAGGCAGG	GA
GCCCAGAACCCACTCTGCC	GA
TCCCATTGACCCTAAGCCA	TA
GATTCGGCCAGCAGTTGAT	GT
TTGCCGTGTGGCGCAAAGC	CG
CTCCCTGAATTTCCAGATG	TG
AATGAACTGGCAATCCGCG	GT
GGCAATCCGCGTCATCTCC	TT
AAAAAAGGCGTCATCACCG	AA
TCATCTGCTCTCCTTGTTA	TA
GCGCCAATGCATATTCCAG	AT
GGTAATAAGGCACCAGCGG	CG
TCGCGCCGGTAAAATCATC	GG
CGCGCTGCGGCGAAGCGTT	TC
GGTTCTGCACCTATGCGAT	CA
CTTCCATATTGTTGGCGGC	TT
CGGGTTTCAGATGTTGTGC	CA
TTGAATTGCTGCCAATGCG	GT
TGACGAACGGCATCCACAC	TC
TGGGCCATGATTTGCCAGT	CA
CAGCGAGCGGACGCCCTGC	CT
GGGAAGGGCGGATAATCCC	CC
GGCGGATAATCCCCATTCC	GC
CAATAAAAGGCACTTCGGT	TG
ACTGGGCCATGATTTGCCA	CG
AATATTACCTTTCGCCGTA	CC
TTGCTGTTCAGGTCTGCGC	AC
ACCAGAACCGCCCGTTACC	GA
CAAATGCACCACCGCTTTA	GC
ACCAGTGCGTCGATTGCTT	CC
AACCCTTTTATTCCCAGGC	AT
GCGGGATCCCCGCACGGGC	AT
AAAAGGCACTTCGGTGAAC	TA
CAGGCAGGAAAGCGCCGTC	GG
GGTATGGTGATCTGATTCA	CC
TAAGGCACCAGCGGGACAT	AT
TGAATTTCCAGATGGTGTT	CC
CGTCGCGGCGTTATCAGAA	AA
GGCAAATAGCGTAGAATGT	AC
ACTAATATTCGCTTGCCGT	AG
GCAAACCACTGGGCCATGA	CT
GTGCCGAAACGACGCCGCA	TG
CAGCGCCAGATGAAAGAGC	AA
CCATGTGCTGTGCAAATGC	AA
AAAAGCCTGATTGTCTGCT	AG
CTTTGGGCTCGTGAAAAAA	TA
TTCCCCCGCATTAATATCT	AC
AACCGGAGAGCACTACGCC	GG
TTCGGCAAACGTCGCGGCG	TT
TTGACCACCAGCACCAGCA	AG
GCCAATGCATATTCCAGTG	CC
ACCTATGCGATAAACTTTT	CC
CACTCTGCCAGTTCGTGTG	CC
TGGTAGACCGTTTTCCACC	TA
AGCGGGACATTTCCCATCC	CG
GGCAGCGTAGCGGATATTA	CT
GAGCGCGTTTTCAGGCTGA	GT
CGCCCAGCGAGCGGACGCC	GC
ATCGAGATTGCCCAGGCAT	GG
CGAAACGACGCCGCAGCGC	CC
CAACCACTGGACAGGAGCG	TC
GCTTATCCAGTGCGTTTAC	GC
TAATTTAAGTGATATTTTG	TT
GTAGAGCAGTATTTGAAAT	AA
TCGGTAACCGGGCCAATAT	AT
ATAACTGCGCTATCGTCTT	GC
AAAAGCAGCGACAGATTGC	TC
GTAAAAAAGCCTGATTGTC	AT
CCTATGCGATAAACTTTTC	AC
CTTGTTCACAATTGAGCGC	AC
AAAACATGTGCCGAAACGA	GC
TCACCGTTAGCGGCTTTTA	TC
TTCCCGTCAGGTAAAAGCA	AG
AGCACGGGTGCCAGTCGTT	CC
CGGCTTCTTGCAGGCTTTC	GA
GCACCGTATTGCTGTTGAA	TT
CACTAGCGATAGTGGAAGA	GA
CAACCTTGCTGTTGCAACC	GA
GGTCATGGGATTTACCGGG	CT
TCCGTTGACCGGCAGGGCC	GG
CAAACGTCGCGGCGTTATC	GA
GGAAGGGCGGATAATCCCC	GA
TCGTTCAAAGGCAATATCG	GC
TACTGCCCGGTACCGTTCA	AG
ACCACCGCTTTACAGCGCG	CG
AGCTCTTCCATATTGTTGG	CC
GGGAAGTGCAGGGCTTTGG	CC
CCCTGAATTTCCAGATGGT	TG
CAAAGGAAGGAGCAAAAGT	AT
ACATGAAACTCAGATCCCG	GT
ACACCTTGTTCGAAAACAT	CG
AAATCATCGGCGATAACGC	AC
CCCATTCCCATTGACCCTA	TA
CTCGCAAAGACTGCTCTAC	TT
CCTGTGGATTGCGCTTCAA	CC
GATAAACCGTACGTCCGTT	TG
ACTTCGGTGAACATCATGG	CA
ATGGTGATCTGATTCACAT	TA
GCACGACGCCTGCCATCAC	GA
TCGCTCATGATAAAAACTC	AT
GCTGTCCAGCCCTTGCAGG	TC
GTAATGTGCTACCTGGCGG	GT
CAGGAAAGCGCCGTCGACC	GA
CTAGTTGAGAAAACAGTGT	GT
GTTTTCGAACATCCAGGAA	GT
TAATCCCCATTCCCCCGCA	AT
TGCACCTATGCGATAAACT	CT
GATTTGCAGGGTGGAGTAG	GT
TCTGCGTGTGCTTCGTGCT	GC
ATATTGTGAATATAAGCGC	GT
AAAGAATGAACTGGCAATC	GC
TTACCTTTCGCCGTACTGT	AC
GTGAACGGACGAATAACGT	TT
CTGCTTTGCGAGCCTGGTT	CA
TCGCCAAATCATCCTTGAG	GA
CCGCATTAATATCTCCGGG	CA
CTGAATTTCCAGATGGTGT	CT
CGGCCAGCAGTTGATTCAT	TT
TGGAGAAGAGATAATGAGG	CC
TACACTTTCCTGGCCCAGA	GA
AGCAGTATTTGAAATAGAT	GC
GTGCTGCTCCCATTCCCAT	AT
CCAATATTACCTTTCGCCG	GT
CCTCTCGCAAAGACTGCTC	TT
TGCAAATGCACCACCGCTT	GT
AAGCGGCCAGAGTTTCAAT	TT
TGCTGTAAGCGAGCCAGCT	TC
AGGGCCGGAGAGAAGACCG	CT
CCATGATTTGCCAGTAAAA	GA
AAATTCCCGTCAGGTAAAA	TG
CAAAAATATCGACGGCTGA	AA
CTCCTTAATTCCGCAATTT	AC
AGAGCAGTATTTGAAATAG	TA
TTGCCAGATTTAAGGGCGA	GG
GGAACACCGTTAATTTGTA	TC
GTGCAGGGCTTTGGCTGTA	AT
TTCCGCCAGATCCTGTGCG	GA
GTGCTCACGTCCGGGAAGG	CG
ATCGGGCGGTCACCGAGAA	GT
CCGCTTTACAGCGCGGATT	AG
ACCTAGTCCCGGTTCTGCA	AC
ATCTGCTCTCCTTGTTAAT	CT
GCGTTACTGGCGCTGGTGA	CA
GCGGTTGGTCATTTGAGAG	GC
TCCGGGAGCGGTATTGAAC	CA
AGCACCGCGTAGCGGTAGC	AC
GCTGAAAGAATGAACTGGC	CA
TGTCAGTATTGCTGAACTA	TA
TGCTCCCATTCCCATTGAC	CC
GGCCCAGAACCCACTCTGC	TC
TGGTTTTGCTCCAGTTGCT	AT
ACCCGCGTTACTGGCGCTG	AG
TGATGGCGCATCCCGGATT	GC
CAGATAACGGATCGGGCGG	TT
TGATACCCGTAGAGCGTCG	TC
CATTTTACCTGTTGGAACA	GC
AACGAGGCATTGCATTAAC	AT
ATACATCACATCCAGCGGG	CA
ATCCCGGATTCGGCCAGCA	CG
GCCAGAGAAAATCTTGATA	TA
CCGGGAGCGGTATTGAACA	TG
GCTGCGGATCGAGATTGCC	CC
GTCTGCGCCCCAGGTAGAA	GA
CGCAAAGACTGCTCTACTT	TT
AAGTGCCATCGCTTCGGCT	CC
TACTGCCGTACCGGGTTTC	TA
GCCATGACAGTCATTTCAC	GC
TTTTCAGGCTGATCACCAG	GT
CAGACCAGAACCGCCCGTT	CA
ATCACCGAAGTTGCCAGAT	CT
TCTTGCAGGCTTTCACCGC	TA
CCTAAGCCAACGATACCGA	CC
AACTTCACGGGCTGGTGCA	CA
GCGATAACGCCAATCTTGA	GT
TCTTGATCATGATTTCGCT	AC
AACGCCGGGGCTGAGTGCT	TT
GCAATCCGCGTCATCTCCT	GC
AGCCAACGATACCGACATG	AA
ATTTGTACCGTTGGTAGAC	AC
CGGTCAGCGCATCAAGCAC	TC
TCATGGATAAATTAGCTGC	AA
TAGAAAGACCTGCGCGGAC	GA
ACGTCATACATCACATCCA	GG
GCACCTGTTTAACCTGGGC	AC
AATTGAGCGCCAATGCATA	CT
GTCAGCGCATCAAGCACCG	GC
GAACCCACTCTGCCAGTTC	AG
CGGAGGCCATGACAGTCAT	CT
AAATCAGCTTTGCCGTTTC	AC
TCAACGTAGCGCAGGCATT	TG
CCCGCTAACAACTGGTGAA	GT
TGCTTTTGGATTTGCAGGG	TT
ACGCCCTGCTTTGCGAGCC	GT
TACCGGGTGATGGCGCATC	TC
GCCAGCGATTGCTGTGTGG	CC
GTCACGCCTTCCGCTGCTA	TA
CGGGATCCCCGCACGGGCT	GG
TGAAACTCAGATCCCGTTT	AT
GGAAAGCGCCGTCGACCAT	AG
TTGATACCCGTAGAGCGTC	GG
CCCGGATTCGGCCAGCAGT	TT
TGTCAGATGGTTTTGCTCC	GA
GCTGGTGCAATTTGACGGT	GA
TAGCCGCGCTGAAAGAATG	AA
ACTACGCCGGAGGTCTCAC	GC
CACAATTGAGCGCCAATGC	TA
TGGGCCAATATGAAACCCT	TT
CCACCAGAAACTGGCGCAT	AC
TGGGGCATCGCGCAAGGCT	GT
CTTTGCCGTTTCCTCCAGC	GT
TCCGGCGGCATTGGTCACG	TA
CCGGCATTTTACCTGTTGG	TA
TTGCTGTAAGCGAGCCAGC	CT
GCCTTCCGCTGCTAACCGC	CG
GTACCGTTCAGCATCTTCG	GC
CGGTATGGTGATCTGATTC	AA
GGAAGTGCAGGGCTTTGGC	GT
CTTGATCATGATTTCGCTC	TC
ATTTCCCATCCGCATCACC	CA
TGAATTGCTGCCAATGCGT	TC
AAGCCTGATTGTCTGCTGC	AC
GCGGTCGGCAGCGTAGCGG	AA
GAGAGCATCCATTAAGGCA	CT
TTCTACTGCCTGACTGGCT	TT
GGTAGCTGAAAAAGGCATT	TG
GCGCCGCTAGTTGAGAAAA	CC
AAATCTTGATAACTGCGCT	AA
GTATTGCTGAACTAACGGA	AC
ACCATTCGCCATCCGCGGC	AG
TTGCTTTTGGATTTGCAGG	GG
GATACAGCGCCAGATGAAA	CG
TCCACCAGAAAACTGGCGA	TT
TATGCGATAAACTTTTCCG	CG
CAAAGACTGCTCTACTTTT	GG
TCAAGCACCGCGTAGCGGT	AA
CTCTTTGGGCTCGTGAAAA	TA
CATTCCCATTGACCCTAAG	CC
TTTGGATTTGCAGGGTGGA	TG
CCGTCGACCATGTGCTGTG	GC
CAAGCACCTGCCTCTTTCA	GA
GCCAGTAAAAAAGCCTGAT	TT
CCTGAATTTCCAGATGGTG	CT
GTAGTTATAGGGAAACAGA	AA
AGGGCTTTGGCTGTATCGG	CC
GGCGGTGGCAAAAACCAGT	TG
CTTTTCGCGCTGCGGCGAA	GG
ATCCCCATTCCCCCGCATT	AA
CATCGGCGATAACGCCAAT	TC
AGGGTTTGTCACCACTTAA	GC
CTGTTCAGGTCTGCGCCCC	GA
TGATCACCAGTGCGTCGAT	CT
GCAAGCACCTGCCTCTTTC	CA
ATAAATTAGCTGCAAAACG	GA
TCATCCTTGAGATGGTAGC	AT
GCCAGGCCAATCGCCAGAC	GC
AAACTGGCGCATCCAGCAT	GT
TCACCACGTATGGTGTGAA	AC
TGTTATTTTATGTGAACTA	GA
CCATTGACCCTAAGCCAAC	CG
TCAGGTCTGCGCCCCAGGT	TA
TCACCGAGAATAAAAATCA	GG
ACAATAAAGCGTGTCACGC	GC
TGCCCGGTACCGTTCAGCA	CT
AGAGGCAGCGTGCCACATC	GA
AGATGGTAGCTGAAAAAGG	GC
GCCAATGGCAGCGGGAAGT	GG
ACCTTGCTGTTGCAACCAG	AC
ACCAGAAAACTGGCGATAT	CC
ATTGCTGAACTAACGGACA	TG
GCGTAGAATGTCAGCAGGA	AC
TGATCATGATTTCGCTCCC	TG
CATCACCGAAGTTGCCAGA	TT
CATCGCGCAAGGCTTCTCC	GC
CGTGAAAAAAAGGCGTCAT	TC
CATATTGTTGGCGGCTTCT	CT
CATTACGAACAAATACCCC	TT
TTCCAGTGCCAGGTCGATG	AT
TGCGTCGATTGCTTCCGGC	GA
TTCATTACGAACAAATACC	AC
TCGAATCCAGCCAGAGCGG	AT
ATGCTGTTGAGGCCAATGG	AC
CGACTTTGGAAAGCCGCTG	GC
TGTCGAAAGTAGAGCAGTA	CT
ATTAATATCTCCGGGAGCG	CG
AGTTGCCAGATTTAAGGGC	AG
AATTCCCGTCAGGTAAAAG	AC
CCACCACATGACGCATCCG	TG
GGCTCGTGAAAAAAAGGCG	GT
AGGAATTTCCGGCGGCATT	CG
CCAGTGCCTGATACTGGCT	GG
AGCCTGGTTACCGTTTTCT	GT
CCTTGCTGTTGCAACCAGC	AT
ATTCCAGTGCCAGGTCGAT	TG
TCAGGCTGATCACCAGTGC	TG
TTGCATTAACTCCTTAATT	AC
AAAACAGTGTTTCTACTGC	GC
GAACGGCATCCACACCTTG	CT
GGCCGGAGAGAAGACCGTA	GA
AACCCGCGTTACTGGCGCT	TG
ATGGCAGCGGGAAGTGCAG	AG
AATAACGTTGCTGCTGTCC	GA
CGAGAGCATCCATTAAGGC	TA
CGGCTTTTCGCGCTGCGGC	CG
CCTGATACTGGCTGGAGAA	GG
GAAAGAGCACCTCTTTCGA	TG
CGAAGCGTTCAATAAAAGG	GC
CCTGACTGGCTTTTTGTGC	GA
TGAACGGACGAATAACGTT	GG
CACCACCGCTTTACAGCGC	GG
GCGGACATATGACAGTGCT	CG
CTAAGCCAACGATACCGAC	CA
TCGCCATCCACCACATGAC	AG
TTGTTCACAATTGAGCGCC	CA
CTAACAACTGGTGAATAAT	GT
TTTGTCACCACTTAACCAT	GT
GAATGAACTGGCAATCCGC	AG
GCGCCGTCGACCATGTGCT	AG
GAGATAATGAGGCTTAACG	AC
TGATCTGATTCACATAAAT	GT
GATTGCTTCCGGCATTTTA	CC
TCGGCTCCGGCAGCAATAT	TG
AGATTGCCCAGGCATGAAC	GC
TAAATACTGCCCGGTACCG	AT
GCGTTTATCGCCCGGTCGG	TT
GATTGCCAGCCGAACCGGT	AT
TCCCGGATTCGGCCAGCAG	AT
CGTGTGGCGCAAAGCGGTC	CG
TCGCTTGCCGTGTGGCGCA	TA
CGCCAGATGAAAGAGCACC	GT
CTGATTCACATAAATTAAC	TA
GAGACAGGCTTATCCAGTG	TC
TGATTCATTACGAACAAAT	TA
GAGGCCAATGGCAGCGGGA	TA
TCGGTCATGGGATTTACCG	GG
GAAGACCGTAAACGGCGTG	AT
ACTAAGCGTTAGTTGCGCC	AG
GCGGGACATTTCCCATCCG	AC
GTTATCAGAAACCCCGCAA	CG
CAGATCCTGTGCGATGCGT	CT
GGCGCTGGTGAACATATTC	TA
TCGGCGATAACGCCAATCT	AT
AGCTGCAAAACGAGGCATT	TG
GCGGTAGCCCTCTTGCTGT	AA
ACCTGGCGGTTGGTCATTT	TG
TCAGATAACGGATCGGGCG	GG
TATTACCTTTCGCCGTACT	AG
GCGTCGCCAAATCATCCTT	AG
TGGTGTTCGGTCAGCGCAT	AC
CGCCGCAGCGCCCTGTGGA	AT
TTGGTAGACCGTTTTCCAC	GC
CCCACGGCACGCCGGGGAA	AA
TGAACATCATGGATAAATT	GA
CAGCTCTTGACGAACGGCA	CT
AGCACCTGTTTAACCTGGG	CC
GATTGCCCAGGCATGAACC	AT
TTCCGGCAACGGCTTCCAG	TC
CCAGGAATTTCCGGCGGCA	TT
AACATATTCAATGCTGTTG	GA
CCACTTAACCATTCGCCAT	AC
ATAAGCGCTGGAAGATAAC	TG
GCACCTGCCTCTTTCAACG	AT
GTCATCTCCTCTCGCAAAG	CA
TTAGCGGCTTTTACTGCAC	GC
CAGTGGAGCAAGTACACTT	CT
TCCATTAAGGCATCGGTAA	AC
GTGCTACCTGGCGGTTGGT	TC
ACGGCGTGTCGAGAGCATC	AC
TGCGCCCACTGCCGGGCCA	TG
AGACCAGAACCGCCCGTTA	CC
TACCTGGCGGTTGGTCATT	CT
TTACGAACAAATACCCCTG	AA
CCCATCCGCATCACCACGT	TA
CTACTGCCTGACTGGCTTT	TT
GCGTCCAGTTTTTCGGCAA	TA
ACCCCTGATAAACCGTACG	TT
GTGAACATATTCAATGCTG	GT
ATGAAAGAGCACCTCTTTC	GG
ACATCACATCCAGCGGGAT	TC
TTGCTTCCGGCATTTTACC	AT
TGTGCAAATGCACCACCGC	CT
CAGTGGGGCATCGCGCAAG	CG
GAATAATTTTTACGGTCGA	TA
TTAACATTGTGTGTTATTT	AT
TTGCTGTGTGGCTTCAACC	AA
GTTTAACCTGGGCCGCATT	TG
GGGCATCGCGCAAGGCTTC	GT
ATTTGACGGTAATGTGCTA	AC
TCACCGCAAACCACTGGGC	TC
GAGCCTGGTTACCGTTTTC	CT
GGACAAAGGAAGGAGCAAA	AA
GAAGCGTTCAATAAAAGGC	CA
ACTGTCGAAAGTAGAGCAG	TT
GCGCCCCAGGTAGAAAGAC	TC
AGAATGAACTGGCAATCCG	AC
ATTGTGAATATAAGCGCTG	TG
AATACTGCCCGGTACCGTT	AC
CATCACCACGTATGGTGTG	GA
GGCATCGGTAACCGGGCCA	AA
TATTCAATGCTGTTGAGGC	AC
GGCTTTTTGTGCACCGTAT	TT
CTGCTGTCCAGCCCTTGCA	GG
TGTGCCGAAACGACGCCGC	AA
GTCGCGCCGGTAAAATCAT	CC
CCGTACCGGGTTTCAGATG	GT
CGGGAAGTGCAGGGCTTTG	GG
GTGAAAAAAAGGCGTCATC	CA
TAGCGCAGGCATTGCTGTT	GC
GAAACGACGCCGCAGCGCC	CC
ACCAAGATCCTTAACAAAA	GA
TCTTTCAACGTAGCGCAGG	CC
GGCTTCAACCACTGGACAG	TG
GGATCGAGATTGCCCAGGC	CA
GAGAAGAGATAATGAGGCT	GT
GACCACCAGCACCAGCAGT	TG
CCGGTACCGTTCAGCATCT	CT
ATGTCTGCGTGTGCTTCGT	GG
TGCCCAGGCATGAACCTGT	TC
CGCATCAAGCACCGCGTAG	GC
TCCAGATCGAATCCAGCCA	TG
GGCTCCGGCAGCAATATGT	CA
GCGGATATTATCGATAAAT	AA
ACGGACGAATAACGTTGCT	AG
CAGAGAAAATCTTGATAAC	CT
GCCAGTGTCAGATGGTTTT	CG
ATGTGCTGTGCAAATGCAC	CC
GGACAGGAGCGCGTTTTCA	TG
TCATACATCACATCCAGCG	GG
TCCAGTTGCTTTTGGATTT	CG
GAAAACAGTGTTTCTACTG	AC
CCGTGTGGCGCAAAGCGGT	GC
GTGGATTGCGCTTCAACCA	TG
GCGGCGAAGCGTTCAATAA	TA
AGTTGCTTTTGGATTTGCA	CG
ACGCCTGCCATCACATGGA	GC
CGGTCATGGGATTTACCGG	TG
AGTGCGTTTACCCACGGCA	CC
CACATCCAGCGGGATCCCC	TG
CATCCTTGAGATGGTAGCT	TG
GGCGTCATCACCGAAGTTG	AC
CGATATCCGTCGCGCCGGT	GA
ACCACTGGGCCATGATTTG	AC
GGGTTTGTCACCACTTAAC	AC
GGCTGAGTGCTTCAACTAA	GT
GCGTAGCGGATATTATCGA	AT
TCTGCCAGTTCGTGTGCAT	CA
AAAAGGCGTCATCACCGAA	AG
GTCAGTGCTGGCGGTGGCA	CA
AATAAAAATCAGCTTTGCC	GG
AGAGCATCCATTAAGGCAT	GC
AGCAAGTACACTTTCCTGG	GC
TTAGCTGCAAAACGAGGCA	AT
TTGTGTGTTATTTTATGTG	AA
CAGGGCCGGAGAGAAGACC	GG
GTGCTTCGTGCTCACGTCC	TG
AGTGCAGGGCTTTGGCTGT	AA
GTTGTGCAACGCCTGTTTC	TA
GTAAACGGCGTGTCGAGAG	CC
TTGACCGGCAGGGCCGGAG	GA
GATAAATACTGCCCGGTAC	CC
AAGTAGAGCAGTATTTGAA	AA
TTCGTGTGCATAAGCGGCC	GA
TAGTTGAGAAAACAGTGTT	CT
ACCGCTTTACAGCGCGGAT	CT
GTCATGGGATTTACCGGGT	GG
CGAGCCTGGTTACCGTTTT	GC
AGGCTTCTCCCTGAATTTC	AC
TCCTTAACAAAAATATCGA	AC
TCCGCTGCTAACCGCGCCG	TC
GTTTTCATCTGCTCTCCTT	CG
TGACTGGCTTTTTGTGCAC	CC
GGGCCGCATTGACCACCAG	TC
TAGCCCTCTTGCTGTAAGC	GG
ATGGCGCATCCCGGATTCG	GG
CGGCGGCATTGGTCACGAC	CG
CGCCTGCCATCACATGGAC	AT
ACCAGACGGGGAAGATAGC	AT
GGTAAAATCATCGGCGATA	CA
GCTTTGGCTGTATCGGCAA	GC
TGCGTCAGTGCTGGCGGTG	AG
CGGTCAGATAACGGATCGG	GG
TCTGATTCACATAAATTAA	AC
GTGAACATCATGGATAAAT	GT
TGAGAAAACAGTGTTTCTA	TC
ACATTTCCCATCCGCATCA	GC
TGGTTACCGTTTTCTTGCG	CC
ACGTCGCGGCGTTATCAGA	AA
CTGCGGTCAGATAACGGAT	CC
CTCTCTTTGGGCTCGTGAA	AA
GCATCCACACCTTGTTCGA	GA
CTACTTTTGCGAAATCGCT	TC
CCCAGGCTCTGTGTGACTA	TC
CCGCAAGCACCTGCCTCTT	CT
TCACATAAATTAACATTGT	TG
TAACGGACAGAATGAATGT	CG
CGCCAATCTTGATCATGAT	AT
GGTCACCGAGAATAAAAAT	CC
TGCGCCGCGCACGTTTCGC	TA
GGCAGCAATATGTACGCCC	CG
TTTTCGCGCTGCGGCGAAG	CC
TGCGTTTACCCACGGCACG	GC
TGTAAGCGAGCCAGCTCTT	CG
ATGATTTGCCAGTAAAAAA	CG
ACCAGCAGTGCGTCCAGTT	CT
TGTCACCACTTAACCATTC	TG
ACTAGCGATAGTGGAAGAA	CA
TTTGCAGGGTGGAGTAGTT	AA
GGCATGAACCTGTCGGTGT	AC
TAAAATCATCGGCGATAAC	GG
ATGAAACCCTTTTATTCCC	TA
TCGATGTCTGCGTGTGCTT	GC
ATCACATGGACTTGTTCAC	CA
GAAGAGATAATGAGGCTTA	AA
AAACAGAAATTCCACAGCA	GT
TCCCGGTTCTGCACCTATG	GC
TAATTTTTACGGTCGAACC	AT
ATTTTACCTGTTGGAACAC	CC
CTCTACTTTTGCGAAATCG	GC
CAGTTGATTCATTACGAAC	GA
CCCTGCTTTGCGAGCCTGG	GT
GCAACCAGACCAAGATCCT	GT
GCTCTTCCATATTGTTGGC	AG
GGACGCCCTGCTTTGCGAG	CC
CAGATTGCCAGCCGAACCG	AG
AGCGGGATCCCCGCACGGG	CC
ATACCGACATGAAACTCAG	GA
TTTGCAACCTTGCTGTTGC	GA
GAAATTCCACAGCATCGAA	AC
TTGCTGTTGCAACCAGCTC	CA
ACCGGGTGATGGCGCATCC	TC
TTGCTGCCAATGCGTCAGT	AG
AGCAAAAGTTGATACCCGT	GA
CAGATGGTTTTGCTCCAGT	TT
GTAATCGCCATCCACCACA	TT
CTGGCGGTGGCAAAAACCA	GG
GCCTGCGACAATAAAGCGT	CG
AAGGCGTCATCACCGAAGT	AT
AGCAATATGTACGCCCGCT	CA
ACGGATCGGGCGGTCACCG	AA
TCCATATTGTTGGCGGCTT	TC
GGGAGCGGTATTGAACAGC	CG
TTGAAATAGATCTGTTTGC	TA
GTCCAGCCCTTGCAGGCAG	TG
AAACCAGTGGAGCAAGTAC	AA
GTGTCAGATGGTTTTGCTC	AC
GAAATAGATCTGTTTGCAA	TC
AACTAAGCGTTAGTTGCGC	GC
TCACGTCCGGGAAGGGCGG	CA
TTCAGGTCTGCGCCCCAGG	GT
GCTGCTCCCATTCCCATTG	TA
TCCGGTTTTCGAACATCCA	AG
TCGCAAAGACTGCTCTACT	CT
CCGGCAACGGCTTCCAGCA	TC
ATCGACGGCTGAATGCGGG	TG
CGTTAGTTGCGCCGCGCAC	GG
GTTCAATAAAAGGCACTTC	CG
TATCAGAAACCCCGCAAGC	TA
TCATGGGATTTACCGGGTG	GA
GATATTTTGTTTGATATTG	TT
ACCGTTTTCTTGCGCCCAC	TT
AACGACGCCGCAGCGCCCT	AG
TCCGGGAAGGGCGGATAAT	GC
AAGAATGAACTGGCAATCC	AG
AGTTTCAATTGAGAGGCAG	GC
GAGTTTCAATTGAGAGGCA	AG
CCCCGCAAGCACCTGCCTC	AT
GGATCGGGCGGTCACCGAG	CA
TGGACAGGAGCGCGTTTTC	CA
AAATATCGACGGCTGAATG	AC
GCATCGAACCCGGCTTTTC	AG
AGTGCCAGGTCGATGTCTG	CC
GGCATTGGTCACGACGTCA	CT
CATCCGGTTTTCGAACATC	GC
TTGACCCTAAGCCAACGAT	AA
GAACCTAGTCCCGGTTCTG	CC
TGACAGTCATTTCACCGTT	AA
GGATAATCCCCATTCCCCC	CG
AAACGACGCCGCAGCGCCC	GT
GATAATGAGGCTTAACGCC	AG
TATCGATAAATACTGCCCG	TG
ATCGCTACCGGAGGCCATG	TA
CTTCGTGCTCACGTCCGGG	GA
CGCATCACCACGTATGGTG	CT
ACTGCGCTATCGTCTTCTT	AT
CATTCCCCCGCATTAATAT	CC
GGATAAATTAGCTGCAAAA	TC
ATCTTCGCCAGCGGGCACG	CA
CACCACGTATGGTGTGAAC	TG
ATCGCTTCGGCTCCGGCAG	CC
CGGGGAAATGGTTGGGCCA	CA
GTTCGTGTGCATAAGCGGC	AC
CAAGGCTTCTCCCTGAATT	GT
ACATGGACTTGTTCACAAT	CT
GGTGGCAAAAACCAGTGGA	CG
ATTGCCCAGGCATGAACCT	GG
CCCCAGGTAGAAAGACCTG	GC
CTTCAACTAATATTCGCTT	GG
CTGGGCCATGATTTGCCAG	AT
CGTTCAATAAAAGGCACTT	GC
CAAATAGCGTAGAATGTCA	GG
GGAAGATAACGGTATGGTG	TA
ACGGTCGAACCTAGTCCCG	TG
GCTGTCGGTCATGGGATTT	AA
GCATTGCTGTTCAGGTCTG	GC
AATGAATGTGTCACATATG	GA
TTTCGCGCTGCGGCGAAGC	TG
CGCTGCTAACCGCGCCGCT	CA
CGAGAATAAAAATCAGCTT	CT
GCCAGTTCCGCCAGATCCT	TG
CCGTTTTCCACCAGAAAAC	AT
TTGCAGGCTTTCACCGCAA	CA
AAACCCTTTTATTCCCAGG	GC
TGATTTCGCTCCCGGTAGA	AG
GACGAACGGCATCCACACC	TT
CGCTATCGTCTTCTTTCCC	GG
GCAGGCTTTCACCGCAAAC	TC
CCTCTTTCGAGGGTTTGTC	AA
GTCCGTTGACCGGCAGGGC	CC
AATATCGACGGCTGAATGC	AG
CTCAGATCCCGTTTTCATC	AT
GAGGCTTAACGCCGGGGCT	TG
GCACTAGCGATAGTGGAAG	AA
AAGGGCGAGTGAGACAGGC	TT
GCAGGGCCGGAGAGAAGAC	GC
CACCAGCAGTGCGTCCAGT	GT
TCGCGCTGCGGCGAAGCGT	TT
CAATGCTGTTGAGGCCAAT	TG
CTTTCGAGGGTTTGTCACC	TA
CATCGGTAACCGGGCCAAT	GA
CCTGGGCCGCATTGACCAC	AC
TTCGGTCAGCGCATCAAGC	GA
CAAGTACACTTTCCTGGCC	GC
ATTACTGCCGTACCGGGTT	CT
TAAGCGGCCAGAGTTTCAA	AT
CATCAGCACTAGCGATAGT	GG
GGCTGTATCGGCAACCAGA	TC
GCATCTTCGCCAGCGGGCA	AC
TTTGCCAGTAAAAAAGCCT	AG
GCTGGTGAACATATTCAAT	CG
GAAATGGTTGGGCCAATAT	GG
CGGAGGTCTCACCGCCTGC	CG
TATGAAACCCTTTTATTCC	AC
ATATAAGCGCTGGAAGATA	AA
TGCCGGGCCAGGCCAATCG	CC
CCTTTCGCCGTACTGTCGA	AA
TCGGTGAACATCATGGATA	TA
GCTGAACTAACGGACAGAA	TT
GAACGGACGAATAACGTTG	TC
AGCAATTTCTTGCGCATCA	TG
ACCAGTGGGGCATCGCGCA	TA
AGAAGAGATAATGAGGCTT	GA
ATACCCGTAGAGCGTCGCC	GA
GGACGAATAACGTTGCTGC	CT
CATCCCGGATTCGGCCAGC	GA
AACCGCCCGTTACCAGTGG	GG
ATCACCAGTGCGTCGATTG	GC
GTATGGTGATCTGATTCAC	GA
GTAGCTGAAAAAGGCATTG	GT
TCGCCAGTAAATTCCCGTC	GA
GCGCCCACTGCCGGGCCAG	TG
CCACTGGACAGGAGCGCGT	AT
CTAACGGACAGAATGAATG	AT
GCCGGGGCTGAGTGCTTCA	CA
AACCGCGCCGCTAGTTGAG	TA
CAACGGCTTCCAGCACGGG	GT
GAACTGGCAATCCGCGTCA	TT
TCCGGCAGCAATATGTACG	CC
GTGCCATCGCTTCGGCTCC	AG
AAGGCACTTCGGTGAACAT	AC
CCGGGCCAATATTACCTTT	AC
TGCCAGATTTAAGGGCGAG	TT
GCGTGTCACGCCTTCCGCT	AG
AGTCATTTCACCGTTAGCG	CG
AGATAACGGTATGGTGATC	AT
ATCGCGCAAGGCTTCTCCC	CT
GCCATGATTTGCCAGTAAA	GA
CGGACAGAATGAATGTGTC	AA
TTACTGGCGCTGGTGAACA	GT
ATCCTTAACAAAAATATCG	GA
CAGCAGTGCGTCCAGTTTT	CT
GTTACCAGTGGGGCATCGC	CG
ATAAACCGTACGTCCGTTG	GA
GCAAACGTCGCGGCGTTAT	GC
TTTCGAGGGTTTGTCACCA	CC
TTTATCGCCCGGTCGGTAA	GT
AGATAACGGATCGGGCGGT	CC
GATCGGGCGGTCACCGAGA	GA
AGCGATTGCTGTGTGGCTT	CC
GCCCAGGCATGAACCTGTC	TG
ATTTCACCTGCGGTCAGAT	AA
GCCAGATGAAAGAGCACCT	CC
TAAACCGTACGTCCGTTGA	AC
ATAACGTTGCTGCTGTCCA	AG
GGTGCCAGTCGTTCAAAGG	GC
CAGCTTTGCCGTTTCCTCC	TA
TGTAATCGCCATCCACCAC	GA
TTGCCCAGGCATGAACCTG	AT
TATGTGAACTAAGCGTTAG	TT
TGCGCTATCGTCTTCTTTC	CC
CCCCGCACGGGCTGCAAGT	TG
GAACCGGTTGCATAGCCGC	CG
AGAGTTTCAATTGAGAGGC	CA
CCAGTTCCGCCAGATCCTG	GT
TTGCGCTTCAACCAGACGG	AG
CATCAACTTCACGGGCTGG	AT
CCAAACAGCACCTGTTTAA	AC
GCCGGTAAAATCATCGGCG	CA
GAACAGCGCCAGTGTCAGA	TT
GGTAGAGTGATGCCAGAGA	CA
AGCTCTTGACGAACGGCAT	CC
CTGCCAGTTCGTGTGCATA	TA
GTTGAATTGCTGCCAATGC	TG
ATGCCAGAGAAAATCTTGA	GT
GCCATCCACCACATGACGC	CA
GTAATAAGGCACCAGCGGG	GA
TTCGCGCTGCGGCGAAGCG	TT
TTCAACCAGACGGGGAAGA	CT
TTCACCTGCGGTCAGATAA	TC
TTGAGCGCCAATGCATATT	AC
TTATAGGGAAACAGAAATT	GC
TAAGCGTTAGTTGCGCCGC	CG
TTCCGGCGGCATTGGTCAC	TG
GTTCAAAGGCAATATCGCT	CA
AATTTGTACCGTTGGTAGA	TC
TGCAAGTGCCATCGCTTCG	CG
CGCCCGTTACCAGTGGGGC	CA
ACCACGTATGGTGTGAACG	CG
CAGTTCCGCCAGATCCTGT	CG
CGGATATTATCGATAAATA	GC
GCTTTTCGCGCTGCGGCGA	GA
CGGTGTCGCCAGTAAATTC	TC
ACCGCCTGCGACAATAAAG	CC
TAAAAGGCACTTCGGTGAA	AC
TCATCACCGAAGTTGCCAG	GA
CCAGAAAACTGGCGATATC	AC
CTTTTATTCCCAGGCTCTG	CT
TTTCATCTGCTCTCCTTGT	TT
AAGCGTGTCACGCCTTCCG	AC
ACAGATTGCCAGCCGAACC	GG
TTCACATAAATTAACATTG	AT
GGAAATGGTTGGGCCAATA	GT
GGCGCAAAGCGGTCGGCAG	TC
GAAGTTGCCAGATTTAAGG	CG
GCTTCGGCTCCGGCAGCAA	CT
GAGCGGTATTGAACAGCGC	GC
TGTTGCAACCAGCTCAGAG	CC
GTGTTTCTACTGCCTGACT	AG
AACCACTGGGCCATGATTT	AG
TTCGGTGAACATCATGGAT	CA
ATGGTTTTGCTCCAGTTGC	GT
CATCACATGGACTTGTTCA	CC
GAGGGTTTGTCACCACTTA	CA
CCAGCCGAACCGGTTGCAT	GA
AGAAACCATTACTGCCGTA	AC
ACTAACGGACAGAATGAAT	AG
ACCGTAAACGGCGTGTCGA	GG
ATGACAGTCATTTCACCGT	CT
TTTTGCGAAATCGCTCATG	CA
TCTGCGCCCCAGGTAGAAA	GG
GCGGCATTGGTCACGACGT	GC
CGGTAATGTGCTACCTGGC	AG
GCTTCTCCCTGAATTTCCA	GG
TCTTCTTTCCCGTAACCCG	GC
TCACAATTGAGCGCCAATG	TC
TGTCGGTCATGGGATTTAC	CC
CTGGGCCGCATTGACCACC	CA
CCACTGCCGGGCCAGGCCA	CA
TTGTCAGTATTGCTGAACT	AA
CAGTTCGTGTGCATAAGCG	CG
TTATCGCCCGGTCGGTAAT	TA
AAAACGAGGCATTGCATTA	CA
GACATATGACAGTGCTGCT	GC
ACCTGCGCGGACATATGAC	GA
GCGGATTGTTGCGATACAG	CC
CTTTTGCGAAATCGCTCAT	AG
CTCACCGCCTGCGACAATA	TA
ATCAACTTCACGGGCTGGT	CG
ATAAAAGGCACTTCGGTGA	AA
CGTAGCGGTAGCCCTCTTG	GC
GATTTGCCAGTAAAAAAGC	TC
TCTCGCAAAGACTGCTCTA	CC
AGCGCCGTCGACCATGTGC	AT
TTTAAGGGCGAGTGAGACA	AG
CCTGTGCGATGCGTTTATC	TG
CATTGTGTGTTATTTTATG	AT
GATGTTGTGCAACGCCTGT	AT
AGATGAAAGAGCACCTCTT	CT
GCATTGCATTAACTCCTTA	GA
CGCCTGCGACAATAAAGCG	CT
TCCCGTCAGGTAAAAGCAG	TC
GCGCATCAAGCACCGCGTA	AG
CAGCGTAGCGGATATTATC	GG
GCAAATGCACCACCGCTTT	TA
ACAAAAATATCGACGGCTG	AA
GGTCGGTAATAAGGCACCA	CG
AATAAGGCACCAGCGGGAC	TA
CTGATACTGGCTGGAGAAG	CA
GCTGGAAGATAACGGTATG	CG
TTCGGCCAGCAGTTGATTC	AA
TCGGCCAGCAGTTGATTCA	TT
GATTGTTGCGATACAGCGC	GC
TAACCGGGCCAATATTACC	GT
CGTTGGTAGACCGTTTTCC	CA
GACAGGAGCGCGTTTTCAG	GG
CCAGAGAAAATCTTGATAA	GC
GGCGTTATCAGAAACCCCG	CC
GCACCACCGCTTTACAGCG	TC
AGCGATAGTGGAAGAAACC	TA
AGCGCGGATTGTTGCGATA	CC
CGACGGCTGAATGCGGGGT	TG
CAACCAGACGGGGAAGATA	TG
CATAAATTAACATTGTGTG	AT
TGGCAAAAACCAGTGGAGC	GA
AACGTCGCGGCGTTATCAG	AA
TGCGCCCCAGGTAGAAAGA	CC
CTGCGTGTGCTTCGTGCTC	TA
GAACATCATGGATAAATTA	TG
TTGCAGGCAGGAAAGCGCC	CG
GCGTCATCTCCTCTCGCAA	CA
CATGTGCTGTGCAAATGCA	CC
CGCATCAGCACTAGCGATA	GG
TCCACAGCATCGAACCCGG	TC
CACAGCATCGAACCCGGCT	CT
TAATAAGGCACCAGCGGGA	GC
CCACACCTTGTTCGAAAAC	TA
GAATGAATGTGTCACATAT	AG
CCGGTCGGTAATAAGGCAC	CC
GAATGTCAGCAGGACAAAG	AG
GTTGGTAGACCGTTTTCCA	CC
AAAATATCGACGGCTGAAT	AG
TGCTGTTGAGGCCAATGGC	AA
CTTTCCCGTAACCCGCGTT	TA
AGCAGCGACAGATTGCCAG	AC
GAACCGCCCGTTACCAGTG	AG
CCGCATCACCACGTATGGT	TG
GTTACCGTTTTCTTGCGCC	GC
GCATTGTCAGTATTGCTGA	GA
AGATTGCCAGCCGAACCGG	CT
CCGGAGAGCACTACGCCGC	AG
TTTCGCAGGCAAATAGCGT	GA
AGGCCATGACAGTCATTTC	GA
ATCCAGCCAGAGCGGTAGC	AA
CGATGCGTTTATCGCCCGG	GT
CGGTTTTCGAACATCCAGG	CA
ATGCACCACCGCTTTACAG	AC
CCAGTTCGTGTGCATAAGC	GG
CAACCAGCTCAGAGCCGCC	GA
GCCTGACTGGCTTTTTGTG	TC
AAAACTCTCTTTGGGCTCG	AT
ACCGCGTAGCGGTAGCCCT	CC
TACTGGCGCTGGTGAACAT	TA
GCGTCGATTGCTTCCGGCA	TT
AGCTCAGAGCCGCCAGCGA	CT
TTAAGTGATATTTTGTTTG	TA
GGAAAGCCGCTGCGGATCG	TA
CAGTGCTGCTCCCATTCCC	AA
GCGGCCAGAGTTTCAATTG	AA
CAATATTACCTTTCGCCGT	CA
CACGTATGGTGTGAACGGA	CC
CTGTGCAAATGCACCACCG	GC
TTTTGTGCACCGTATTGCT	TG
TTGAACAGCGCCAGTGTCA	AG
TCCACACCTTGTTCGAAAA	AC
CCAGCGGGATCCCCGCACG	TG
ATGTGAACTAAGCGTTAGT	TT
GCAAAGACTGCTCTACTTT	CT
TCAAAGGCAATATCGCTAC	TC
CCGCGCACGTTTCGCAGGC	GA
ACGGCACGCCGGGGAAATG	CG
GCCCTCTTGCTGTAAGCGA	AG
GGAGCAAAAGTTGATACCC	AG
GAACTAACGGACAGAATGA	TA
ATCAGAAACCCCGCAAGCA	TC
TTTGTACCGTTGGTAGACC	AG
CCTGCGCGGACATATGACA	AG
CCCATTCCCCCGCATTAAT	CA
GTAGCGGTAGCCCTCTTGC	CT
CCGACATGAAACTCAGATC	AC
CCAGCATTTCCAGATCGAA	TT
CTTGTTAATTTAAGTGATA	CT
GGCAGCGTGCCACATCAAC	AT
CCAGCACCAGCAGTGCGTC	AC
GACAGTCATTTCACCGTTA	TG
CGCGCACGTTTCGCAGGCA	CA
CCAGCTCTTGACGAACGGC	GA
CTTGCTGTAAGCGAGCCAG	TC
AGGAGCAAAAGTTGATACC	AC
GCCTCTTTCAACGTAGCGC	TA
CTGCAAGTGCCATCGCTTC	GG
CACTTCGGTGAACATCATG	GG
AAATGGTTGGGCCAATATG	GA
CATCACATCCAGCGGGATC	AC
GACCAGAACCGCCCGTTAC	AC
AGACTGCTCTACTTTTGCG	AA
TATTGTGAATATAAGCGCT	AG
TGGGCTCGTGAAAAAAAGG	TC
GAAACCCTTTTATTCCCAG	TG
CCCGCGTTACTGGCGCTGG	AT
TGGATAAATTAGCTGCAAA	AA
CGCTAGTTGAGAAAACAGT	CG
GCCGTTTCCTCCAGCTCTT	TC
ACCCTTTTATTCCCAGGCT	AC
GATCACCAGTGCGTCGATT	TG
TTTTCGAACATCCAGGAAT	GT
CAGTGCGTCCAGTTTTTCG	GG
CGCTGAAAGAATGAACTGG	GC
GCACCTCTTTCGAGGGTTT	AG
CACCGCAAACCACTGGGCC	TA
CTTCTTTCCCGTAACCCGC	TG
AAACCCCGCAAGCACCTGC	GC
GCCGTACCGGGTTTCAGAT	TG
GCTGTTCAGGTCTGCGCCC	TC
TTGGTCATTTGAGAGCATG	GA
CAGGAATTTCCGGCGGCAT	CT
AAGATCCTTAACAAAAATA	CT
GCCCTGTGGATTGCGCTTC	CA
AACAGCACCTGTTTAACCT	AG
TTCGGCTCCGGCAGCAATA	CT
GTTTTCAGGCTGATCACCA	CG
CCGTTTTCATCTGCTCTCC	CT
AGGCCAATGGCAGCGGGAA	GG
TGAAAGAGCACCTCTTTCG	AA
ATTGCTGTGTGGCTTCAAC	GC
ACGCCGGGGCTGAGTGCTT	AC
CTGGTTACCGTTTTCTTGC	CG
GTACCGGGTTTCAGATGTT	CG
GCCAATCGCCAGACCAGAA	GC
CCCAGGCATGAACCTGTCG	GG
CACCACCAGAAACTGGCGC	GA
GTCACCGAGAATAAAAATC	GA
CCAGCAGTTGATTCATTAC	GG
AACTGCGCTATCGTCTTCT	TT
TGGCTTTTTGTGCACCGTA	CT
GTGCATAAGCGGCCAGAGT	TT
TGGCGCTGGTGAACATATT	CC
GAAAGAATGAACTGGCAAT	TC
TTTCCGGCAACGGCTTCCA	TG
GCATCCATTAAGGCATCGG	AT
CTGAGTGCTTCAACTAATA	GT
AGAGCCGCCAGCGATTGCT	CG
ACGCCTGTTTCACCAAACA	AG
TCGACCATGTGCTGTGCAA	GA
GCTCTGTGTGACTACGCCG	GG
CGGTTGCATAGCCGCGCTG	CA
AATGTGCTACCTGGCGGTT	TG
ACTGGCGCTGGTGAACATA	TT
AGTTGAGAAAACAGTGTTT	TC
TGTGAACGGACGAATAACG	GT
CCGTACGTCCGTTGACCGG	AC
TCGCGCAAGGCTTCTCCCT	AG
CACGCCGGGGAAATGGTTG	GG
GAAAAAAAGGCGTCATCAC	TC
CCGCTAACAACTGGTGAAT	CA
ATCTTGATAACTGCGCTAT	AC
CGCATTAATATCTCCGGGA	CG
AGACCGTAAACGGCGTGTC	AG
CTCCCATTCCCATTGACCC	GT
CTGCGGATCGAGATTGCCC	GA
CAGACCAAGATCCTTAACA	CA
GGAGCGGTATTGAACAGCG	GC
CAAGTGCCATCGCTTCGGC	GT
CGTTACTGGCGCTGGTGAA	GC
GGAGGCCATGACAGTCATT	CT
TGACAGTGCTGCTCCCATT	AC
GGTGCAATTTGACGGTAAT	TG
GGGCCAGGCCAATCGCCAG	CA
GGAATTTCCGGCGGCATTG	AG
AAGCGCCGTCGACCATGTG	AC
ATCGCCAGACCAGAACCGC	AC
TATGGTGTGAACGGACGAA	GT
ATTTCACCGTTAGCGGCTT	CT
GCTTAACGCCGGGGCTGAG	GT
ACAGAAATTCCACAGCATC	AG
TTTGCGAGCCTGGTTACCG	CT
GGCTCTGTGTGACTACGCC	AG
GCACCACCAGAAACTGGCG	TC
CGTCATCTCCTCTCGCAAA	GG
TACCTGTTGGAACACCGTT	TA
ATGAATGTGTCACATATGA	AC
AAGACCTGCGCGGACATAT	AG
CACCGCCTGCGACAATAAA	TG
CGAAAGTAGAGCAGTATTT	TG
GAACCTGTCGGTGTCGCCA	TG
GCAGGACAAAGGAAGGAGC	AA
TTTCCCATCCGCATCACCA	AC
TGAACCGGAGAGCACTACG	AC
GCTTCCGGCATTTTACCTG	TT
TGTCACGCCTTCCGCTGCT	GA
TACTGTCGAAAGTAGAGCA	GG
TATCGACGGCTGAATGCGG	AG
GCGCATCCCGGATTCGGCC	GA
TTGTTCGAAAACATGTGCC	CG
TTTAAGTGATATTTTGTTT	AG
ACTGCCGGGCCAGGCCAAT	CC
GCTCTTGACGAACGGCATC	AC
CGAAAACATGTGCCGAAAC	TG
GCTATCGTCTTCTTTCCCG	CT
GCGGTCACCGAGAATAAAA	GA
ACCTTGTTCGAAAACATGT	CG
CTTTGGCTGTATCGGCAAC	GC
AACTGGCGATATCCGTCGC	AG
AGCGCCAATGCATATTCCA	GG
GGTCACGACGTCATACATC	TA
CCAGGCCAATCGCCAGACC	GA
AACTGGCGCATCCAGCATT	AT
CTCCAGCTCTTCCATATTG	CT
ATCCATTAAGGCATCGGTA	CA
GCCAGATTTAAGGGCGAGT	TG
GTCAGTATTGCTGAACTAA	TC
CAGAGCCGCCAGCGATTGC	TT
CGCCGGGGCTGAGTGCTTC	AA
TGAACATATTCAATGCTGT	GT
TTCACCGTTAGCGGCTTTT	TA
GCATCCAGCATTTCCAGAT	CC
CCATCCGCGGCGACTTTGG	GA
TGATAAAAACTCTCTTTGG	AG
ATCAGCTTTGCCGTTTCCT	AC
CCAGTAAATTCCCGTCAGG	GT
AGCTGAAAAAGGCATTGTC	TA
TTAATTTGTACCGTTGGTA	GG
TGCAGGGCTTTGGCTGTAT	GC
ACAGTGCTGCTCCCATTCC	GC
TGCACCACCAGAAACTGGC	CG
AGTATTTGAAATAGATCTG	CT
TCGATAAATACTGCCCGGT	AA
AAATACTGCCCGGTACCGT	TT
ACGCATCCGGTTTTCGAAC	GA
GATGTCTGCGTGTGCTTCG	CT
ATAAAAACTCTCTTTGGGC	GT
AGTGGAAGAAACCATTACT	TG
CGCTGCGGATCGAGATTGC	CC
TGAAAAAGGCATTGTCAGT	CA
ATCACCACGTATGGTGTGA	CA
TTCCATATTGTTGGCGGCT	CT
TCTGTTTGCAACCTTGCTG	AT
GCCGTCGACCATGTGCTGT	CG
ATATCGCTACCGGAGGCCA	AT
CTTCCGGCATTTTACCTGT	GT
TAAAAACTCTCTTTGGGCT	AC
GCTCCAGTTGCTTTTGGAT	TT
AGCCCTCTTGCTGTAAGCG	TA
TTCCGCTGCTAACCGCGCC	CG
GTGTGTTATTTTATGTGAA	TC
AGACCTGCGCGGACATATG	AA
AAACAGTGTTTCTACTGCC	AT
TACGCCGCGCCCAGCGAGC	CG
CAGTTGCTTTTGGATTTGC	CA
TCCCCGCACGGGCTGCAAG	AT
CCCCGCATTAATATCTCCG	CG
CAGACGGGGAAGATAGCTG	CT
CATGGACTTGTTCACAATT	AG
TTAATATCTCCGGGAGCGG	AT
CTGCTCTCCTTGTTAATTT	TA
AATTTCCGGCGGCATTGGT	GC
CTCATGATAAAAACTCTCT	GT
TTATTCCCAGGCTCTGTGT	TG
CTGGTGAATAATTTTTACG	AG
ATGGTGTTCGGTCAGCGCA	GT
CATAGCCGCGCTGAAAGAA	GT
ACAGAATGAATGTGTCACA	GT
TCGCTACCGGAGGCCATGA	AC
ACGCCGGGGAAATGGTTGG	CG
GCACTACGCCGCGCCCAGC	AG
CCCGTCAGGTAAAAGCAGC	TG
AGCGAGCCAGCTCTTGACG	AA
CCACAGCATCGAACCCGGC	TT
CATTTCCCATCCGCATCAC	AC
CGTCGACCATGTGCTGTGC	CA
GGCATTGCATTAACTCCTT	AA
CTGAACTAACGGACAGAAT	GG
CTGCTGCCAGTTCCGCCAG	TA
GCATCAAGCACCGCGTAGC	CG
AACGGACGAATAACGTTGC	GT
GTAGCGGATATTATCGATA	CA
AATGTGTCACATATGACCA	GF
GATACCCGTAGAGCGTCGC	TC
CGCTGGAAGATAACGGTAT	GG
AGATAATGAGGCTTAACGC	GC
TGCAGGCTTTCACCGCAAA	TC
CGTACGTCCGTTGACCGGC	CA
ATGAACTGGCAATCCGCGT	AC
GCAGCGTGCCACATCAACT	GT
ATACTGGCTGGAGAAGAGA	GT
TTCCCGTAACCCGCGTTAC	TT
GCAAAAACCAGTGGAGCAA	GG
TCCTCTCGCAAAGACTGCT	CC
CCAGAACCCACTCTGCCAG	CT
TTGAGAGGCAGCGTGCCAC	AA
CCTTGTTAATTTAAGTGAT	TA
TGCCGTTTCCTCCAGCTCT	TT
TCCAGTGCCAGGTCGATGT	TC
TAACTGCGCTATCGTCTTC	AT
GAAAACATGTGCCGAAACG	CA
ATGCGTTTATCGCCCGGTC	GG
CTGTCGAAAGTAGAGCAGT	AA
GCTGAATGCGGGGTGTAAT	GC
GAAGGAGCAAAAGTTGATA	GC
TGTGCAACGCCTGTTTCAC	TC
TGGAAAGCCGCTGCGGATC	TG
ATATCCGTCGCGCCGGTAA	GA
TTGCGAAATCGCTCATGAT	TA
TCATCTCCTCTCGCAAAGA	GC
GTGATGGCGCATCCCGGAT	GT
CGGCGACTTTGGAAAGCCG	GC
ACGCCAATCTTGATCATGA	AT
CCAAGATCCTTAACAAAAA	AT
TTCTCCCTGAATTTCCAGA	CT
TCTGTGTGACTACGCCGGA	CG
GGAAACAGAAATTCCACAG	GC
CGACAATAAAGCGTGTCAC	GG
TCCGGCAACGGCTTCCAGC	TA
CACCTGCGGTCAGATAACG	TG
GCGGATAATCCCCATTCCC	GC
CGTTTTCCACCAGAAAACT	CG
TTCTGCACCTATGCGATAA	GA
AAAGGCATTGTCAGTATTG	AC
AAAGTAGAGCAGTATTTGA	GA
CTGTTGCAACCAGCTCAGA	GG
ACCGCGCCGCTAGTTGAGA	AA
AATTAACATTGTGTGTTAT	AT
GCGCGTTTTCAGGCTGATC	AA
GGCGTGTCGAGAGCATCCA	CT
AAAAATATCGACGGCTGAA	CT
CCAGAAACTGGCGCATCCA	AG
CAACTAATATTCGCTTGCC	TG
TTTACAGCGCGGATTGTTG	CC
GATAACGGATCGGGCGGTC	AA
GATGCGTTTATCGCCCGGT	CC
ACGGTATGGTGATCTGATT	AC
CTGTGGATTGCGCTTCAAC	CC
AAGCGAGCCAGCTCTTGAC	TG
TTAGTTGCGCCGCGCACGT	GT
AATTGAGAGGCAGCGTGCC	CA
AGATCCTTAACAAAAATAT	AC
CTCGTGAAAAAAAGGCGTC	GA
AGCACCTCTTTCGAGGGTT	GT
CAGCACTAGCGATAGTGGA	TA
GCAGTATTTGAAATAGATC	AT
CCAGTGCGTTTACCCACGG	TC
GCACGCCGGGGAAATGGTT	GG
AAAGCCTGATTGTCTGCTG	AC
GATGGTTTTGCTCCAGTTG	AC
GCGCACGTTTCGCAGGCAA	CA
CGTCCGGGAAGGGCGGATA	AA
GTCAGCAGGACAAAGGAAG	TG
GTCGAACCTAGTCCCGGTT	GC
TTCACCAAACAGCACCTGT	TT
GTAACCCGCGTTACTGGCG	CC
ATTTTGTTTGATATTGTGA	TA
TGCTGAACTAACGGACAGA	TA
TTGAGAAAACAGTGTTTCT	GA
CGGTAGAGTGATGCCAGAG	CA
TACTTTTGCGAAATCGCTC	CA
TCACGACGTCATACATCAC	GA
AGGCTTAACGCCGGGGCTG	GA
GAGTAGTTATAGGGAAACA	GG
GCTGCAAGTGCCATCGCTT	GC
TGACCGGCAGGGCCGGAGA	TG
TAACGCCGGGGCTGAGTGC	TT
TGCACCACCGCTTTACAGC	AG
GTTTTGCTCCAGTTGCTTT	GT
ATAAACTTTTCCGGCAACG	GG
CACATGACGCATCCGGTTT	CT
ACGGGGAAGATAGCTGTCG	GG
TCGGGCGGTCACCGAGAAT	AA
AGAGATAATGAGGCTTAAC	AG
TTTTATTCCCAGGCTCTGT	CG
ATTGCTGCCAATGCGTCAG	AT
CTGTCCAGCCCTTGCAGGC	GA
CCGCGCTGAAAGAATGAAC	GT
CAACTGGTGAATAATTTTT	AA
GTCAGATAACGGATCGGGC	GG
TTCGTGCTCACGTCCGGGA	CA
GGGGAAGATAGCTGTCGGT	CC
CCATTCGCCATCCGCGGCG	AA
CCTGCGACAATAAAGCGTG	GT
CTTCAACCACTGGACAGGA	GG
ATTCCCGTCAGGTAAAAGC	AA
CAGCAGTTGATTCATTACG	CA
TTAAGGGCGAGTGAGACAG	TG
GATAATCCCCATTCCCCCG	GC
CGCTGGTGAACATATTCAA	GT
CCGCCAGATCCTGTGCGAT	TG
TGCGGTCAGATAACGGATC	CG
ACTCAGATCCCGTTTTCAT	AC
GCAGTGCGTCCAGTTTTTC	AG
TCGCTTCGGCTCCGGCAGC	AA
GCCGGGCCAGGCCAATCGC	TC
GGCAAAAACCAGTGGAGCA	TA
TTAACAAAAATATCGACGG	CC
ATTTCGCTCCCGGTAGAGT	GG
AAGAGATAATGAGGCTTAA	GC
GCGTAGCGGTAGCCCTCTT	CG
GTCACCACTTAACCATTCG	TC
AACCACTGGACAGGAGCGC	CG
CGTTGACCGGCAGGGCCGG	CA
GTTCCGCCAGATCCTGTGC	AG
CTACGCCGCGCCCAGCGAG	AC
TTGCTCCAGTTGCTTTTGG	TA
CCAATGCATATTCCAGTGC	GC
CAATGGCAGCGGGAAGTGC	CA
AAACAGCACCTGTTTAACC	CT
TGCTACCTGGCGGTTGGTC	GA
ATGCGTCAGTGCTGGCGGT	AG
CCGTAGAGCGTCGCCAAAT	CC
ACCCGTAGAGCGTCGCCAA	TA
CAGTGTTTCTACTGCCTGA	AC
CGATGTCTGCGTGTGCTTC	TG
AGAACCGCCCGTTACCAGT	CG
GCTTCAACCACTGGACAGG	GA
GGCATTTTACCTGTTGGAA	CC
GCGCTGGAAGATAACGGTA	AT
GCTTTTTGTGCACCGTATT	GG
AGTCCCGGTTCTGCACCTA	TT
CCGGATTCGGCCAGCAGTT	CG
GGCCATGATTTGCCAGTAA	GA
GTATTGCTGTTGAATTGCT	CG
CGGGCCAATATTACCTTTC	CG
GCTGTGTGGCTTCAACCAC	TT
CCTCTTGCTGTAAGCGAGC	CC
GTGTCGCCAGTAAATTCCC	GG
GCGTGCCACATCAACTTCA	AC
CTGAAAAAGGCATTGTCAG	GT
AATGCGTCAGTGCTGGCGG	CT
CAGCGCATCAAGCACCGCG	TT
TGCCAGGTCGATGTCTGCG	GT
TGTGTGGCTTCAACCACTG	CG
GGCTTATCCAGTGCGTTTA	AC
AAAAGTTGATACCCGTAGA	CG
AGAAAGACCTGCGCGGACA	TT
CGATAAATACTGCCCGGTA	TC
CAGAACCCACTCTGCCAGT	CT
GTGTAATCGCCATCCACCA	GC
GCCCAGCGAGCGGACGCCC	CT
ATGTCAGCAGGACAAAGGA	AA
GGTAGAAAGACCTGCGCGG	AA
ACAGCGCCAGTGTCAGATG	AG
TATCGCCCGGTCGGTAATA	TA
TAATTCCGCAATTTCACCT	TG
ATCGCCCGGTCGGTAATAA	TG
GTTGCATAGCCGCGCTGAA	GA
TATAGGGAAACAGAAATTC	TC
AGCATCCATTAAGGCATCG	GG
CTTATCCAGTGCGTTTACC	GC
TCCGGCATTTTACCTGTTG	TG
TTTTTGTGCACCGTATTGC	CT
GCCAATGCGTCAGTGCTGG	TC
ACGCCGCGCCCAGCGAGCG	TG
CTGTTTCACCAAACAGCAC	CC
GGCAACGGCTTCCAGCACG	CG
ACGACGCCTGCCATCACAT	CG
TGTGGCGCAAAGCGGTCGG	GC
TCTCCCTGAATTTCCAGAT	TG
AACGGCGTGTCGAGAGCAT	AC
CGGTTGGTCATTTGAGAGC	GA
CATGGGATTTACCGGGTGA	TT
ACTTCACGGGCTGGTGCAA	AT
ATTAACTCCTTAATTCCGC	CA
TGCATTAACTCCTTAATTC	TC
ATAGCGTAGAATGTCAGCA	AG
TAACATTGTGTGTTATTTT	TA
ACCGTTCAGCATCTTCGCC	TA
GCCCTGCTTTGCGAGCCTG	CG
TGTCGCCAGTAAATTCCCG	GT
TTAACGCCGGGGCTGAGTG	CC
CTACCGGAGGCCATGACAG	GT
GGCCAATATGAAACCCTTT	GT
AAACGTCGCGGCGTTATCA	CG
TTCTTGCAGGCTTTCACCG	CC
TCAGGTAAAAGCAGCGACA	GG
CCCAGCGAGCGGACGCCCT	GG
CGCGTTACTGGCGCTGGTG	CA
GAGTGAGACAGGCTTATCC	CA
AACCAGACCAAGATCCTTA	CA
CCGGGGAAATGGTTGGGCC	GA
TGAACAGCGCCAGTGTCAG	TA
GTAACCGGGCCAATATTAC	GC
CCAGCCAGAGCGGTAGCAA	TT
GCAGGGTGGAGTAGTTATA	TG
AAGAGCACCTCTTTCGAGG	AG
CCAGCGGGCACGACGCCTG	GC
GCTGCGGCGAAGCGTTCAA	CT
AGTACACTTTCCTGGCCCA	AG
TTGTTGGCGGCTTCTTGCA	AG
GTTGACCGGCAGGGCCGGA	CG
AAAGGAAGGAGCAAAAGTT	CG
CACTGCCGGGCCAGGCCAA	CT
GCGGGGTGTAATCGCCATC	TC
GCCGCGCCCAGCGAGCGGA	CC
CGGATCGAGATTGCCCAGG	GC
GTGTGAACGGACGAATAAC	GG
AAAGAGCACCTCTTTCGAG	GG
TAGCGATAGTGGAAGAAAC	CC
TCAATAAAAGGCACTTCGG	TT
CAAACAGCACCTGTTTAAC	CC
ATTTAAGTGATATTTTGTT	AT
GCCGTGTGGCGCAAAGCGG	TT
CCACTGGGCCATGATTTGC	AC
AGCGGTCGGCAGCGTAGCG	AG
AAAATCATCGGCGATAACG	TC
GCAACCTTGCTGTTGCAAC	TC
CAGCCGAACCGGTTGCATA	CG
TCAGAGCCGCCAGCGATTG	CC
GTCCCGGTTCTGCACCTAT	AG
GTGAGACAGGCTTATCCAG	AT
AGAGCATGAACCGGAGAGC	GA
GGAGCAAGTACACTTTCCT	TG
CGACAGATTGCCAGCCGAA	GC
GGGCTTTGGCTGTATCGGC	AA
GCGGCTTTTACTGCACCAC	AC
AGTGCGTCGATTGCTTCCG	CG
CCGCGTAGCGGTAGCCCTC	AT
AAAGTTGATACCCGTAGAG	AC
AACATGTGCCGAAACGACG	AC
GCAAAACGAGGCATTGCAT	TT
TTGACGAACGGCATCCACA	CC
ATTGCTTCCGGCATTTTAC	GC
TATTCCCAGGCTCTGTGTG	TA
CGCCCCAGGTAGAAAGACC	GT
CCAGATGGTGTTCGGTCAG	TC
TCCTGTGCGATGCGTTTAT	AC
TCGCAGGCAAATAGCGTAG	TA
ATTTGCAGGGTGGAGTAGT	GT
AGCGCCCTGTGGATTGCGC	CT
TGAACTAACGGACAGAATG	CA
GGCTGCAAGTGCCATCGCT	GT
CGTTAGCGGCTTTTACTGC	CA
TGACGGTAATGTGCTACCT	TG
GGGAAGATAGCTGTCGGTC	GA
CCACATGACGCATCCGGTT	AT
AGAAACTGGCGCATCCAGC	CA
GACTTTGGAAAGCCGCTGC	CG
TCAGATGTTGTGCAACGCC	TT
GTTGGGCCAATATGAAACC	GC
TGACTACGCCGGAGGTCTC	GA
TGCGTCCAGTTTTTCGGCA	GA
ATGACGCATCCGGTTTTCG	CA
TTTCACCAAACAGCACCTG	GT
AATATCGCTACCGGAGGCC	CA
TCCAGCGGGATCCCCGCAC	AG
GTTCAGGTCTGCGCCCCAG	TG
GTGAATATAAGCGCTGGAA	TG
GCGTGTGCTTCGTGCTCAC	TG
ACTGCCCGGTACCGTTCAG	TC
TCCAGCTCTTCCATATTGT	CT
GCACGGGTGCCAGTCGTTC	AA
GAAACCATTACTGCCGTAC	AC
AATCATCGGCGATAACGCC	AA
GACCATGTGCTGTGCAAAT	CG
CGAATAACGTTGCTGCTGT	AC
GCCAGCGGGCACGACGCCT	CG
CAGCGGGACATTTCCCATC	CC
GATATCCGTCGCGCCGGTA	CA
GTTCGGTCAGCGCATCAAG	TC
TTATCAGAAACCCCGCAAG	GC
AGCCAGTGCCTGATACTGG	TC
TAGAGCGTCGCCAAATCAT	GC
GCGCCAGATGAAAGAGCAC	AC
CTGGAGAAGAGATAATGAG	GG
CGCAGGCATTGCTGTTCAG	GG
CCCATTGACCCTAAGCCAA	TC
GAAGGGCGGATAATCCCCA	GT
GGAAGATAGCTGTCGGTCA	GT
GTTTGCAACCTTGCTGTTG	TC
CGACGCCTGCCATCACATG	AG
ATATGTACGCCCGCTAACA	AA
TACCCACGGCACGCCGGGG	TA
CCGCGTCATCTCCTCTCGC	TA
TTGCTGCTGTCCAGCCCTT	GG
CCAGTGGAGCAAGTACACT	AT
GACGGGGAAGATAGCTGTC	AG
TGTTTCTACTGCCTGACTG	GG
TGCTTTGCGAGCCTGGTTA	CC
TGCAACCTTGCTGTTGCAA	TC
CAGGGCTTTGGCTGTATCG	GG
AGCGGCTTTTACTGCACCA	TC
GCTGAGTGCTTCAACTAAT	GA
GTTTGATATTGTGAATATA	TA
CTGATAAACCGTACGTCCG	CT
CTGATTGTCTGCTGCCAGT	CT
CTGTGTGGCTTCAACCACT	GG
TAAAGCGTGTCACGCCTTC	AC
TAACAACTGGTGAATAATT	CT
ATTACCTTTCGCCGTACTG	TT
GAAAAAGGCATTGTCAGTA	TT
ATTGACCACCAGCACCAGC	CA
CTGTGCGATGCGTTTATCG	CC
GGGCCAATATGAAACCCTT	TT
CGCCCGGTCGGTAATAAGG	TC
CCGTAAACGGCGTGTCGAG	AA
AAGTGATATTTTGTTTGAT	TA
GGCTTAACGCCGGGGCTGA	AG
ATTTGAGAGCATGAACCGG	CA
TGTTCGAAAACATGTGCCG	TA
TAATCGCCATCCACCACAT	GG
CTCACGTCCGGGAAGGGCG	GG
TTGATAACTGCGCTATCGT	CC
TCCGCGTCATCTCCTCTCG	AC
TCGAACCCGGCTTTTCGCG	AC
CAGGCTGATCACCAGTGCG	TT
AATTCCACAGCATCGAACC	AC
TCTACTGCCTGACTGGCTT	TT
CTTTTGGATTTGCAGGGTG	GG
TTTGCTCCAGTTGCTTTTG	TG
TTGTACCGTTGGTAGACCG	TT
TCAACTAATATTCGCTTGC	TC
CCTTCCGCTGCTAACCGCG	GC
GCGTGTCGAGAGCATCCAT	GT
CCAGATGAAAGAGCACCTC	GT
CATCCAGCATTTCCAGATC	GG
TTTCGCCGTACTGTCGAAA	CG
CGCTTGCCGTGTGGCGCAA	TA
CGGTGAACATCATGGATAA	TA
GGGCACGACGCCTGCCATC	CA
CAGCCAGAGCGGTAGCAAT	CT
TTAAGGCATCGGTAACCGG	AG
AAATAGATCTGTTTGCAAC	GC
AGATCGAATCCAGCCAGAG	CC
GTAGAAAGACCTGCGCGGA	GC
CCTGCCTCTTTCAACGTAG	AC
GGTTACCGTTTTCTTGCGC	TC
GGGTTTCAGATGTTGTGCA	CA
TTTGTGCACCGTATTGCTG	TT
CCATGACAGTCATTTCACC	GG
CTGCCTCTTTCAACGTAGC	CG
GTGGGGCATCGCGCAAGGC	AT
AGAACCCACTCTGCCAGTT	CC
GGTGTTCGGTCAGCGCATC	TA
GATTTAAGGGCGAGTGAGA	AC
ATCCAGCGGGATCCCCGCA	CC
TTTCAGGCTGATCACCAGT	TG
GCCGTACTGTCGAAAGTAG	CA
ATCGTCTTCTTTCCCGTAA	TC
AGATGGTGTTCGGTCAGCG	CC
CTGAAAGAATGAACTGGCA	GA
GGAGTAGTTATAGGGAAAC	TA
TGTTTGCAACCTTGCTGTT	CG
TGCTCACGTCCGGGAAGGG	GC
CATTGCATTAACTCCTTAA	GT
AGCCGCTGCGGATCGAGAT	AT
TCCTCCAGCTCTTCCATAT	TT
TACCGGGTTTCAGATGTTG	GT
GTCTGCTGCCAGTTCCGCC	TA
GTGGCAAAAACCAGTGGAG	GC
TGAACCTGTCGGTGTCGCC	AA
AACCAGTGGAGCAAGTACA	AC
CCGGTAGAGTGATGCCAGA	CG
AATAAAAGGCACTTCGGTG	CA
CAGGTCTGCGCCCCAGGTA	TG
AGGGCGAGTGAGACAGGCT	AT
CGGTCGAACCTAGTCCCGG	AT
TTTTCCACCAGAAAACTGG	GC
TGAGAGCATGAACCGGAGA	TG
CGCCGGGGAAATGGTTGGG	AC
CAGGCCAATCGCCAGACCA	CG
TGAGACAGGCTTATCCAGT	GG
TGGTGAATAATTTTTACGG	CT
GGCAACCAGACCAAGATCC	CT
AAGACCGTAAACGGCGTGT	GC
CCGGTAAAATCATCGGCGA	GT
GACGCATCCGGTTTTCGAA	TC
CCTCCAGCTCTTCCATATT	TG
TGTATCGGCAACCAGACCA	CA
AGCCGAACCGGTTGCATAG	CC
CTGGCGGTTGGTCATTTGA	CG
GCGCGGACATATGACAGTG	TC
GTCACGACGTCATACATCA	GC
TGCTGCCAATGCGTCAGTG	TC
ATATTTTGTTTGATATTGT	GG
GCAACCAGCTCAGAGCCGC	TC
ATCCGGTTTTCGAACATCC	CA
GCCAGTGCCTGATACTGGC	AT
CCATCGCTTCGGCTCCGGC	GA
TGAATAATTTTTACGGTCG	GA
CGTTTTCATCTGCTCTCCT	CT
GACGCCTGCCATCACATGG	CA
GTACGTCCGTTGACCGGCA	CG
TGCTGTTGCAACCAGCTCA	TG
AAAGGCGTCATCACCGAAG	AT
AGACGGGGAAGATAGCTGT	CC
GGTCGGCAGCGTAGCGGAT	CA
CATCCACCACATGACGCAT	CC
TACAGCGCGGATTGTTGCG	TA
CGAGCGGACGCCCTGCTTT	GG
GGTCGATGTCTGCGTGTGC	AT
ACCTGTCGGTGTCGCCAGT	AA
TGGTGTGAACGGACGAATA	AA
GTGCGATGCGTTTATCGCC	TC
TCAGCAGGACAAAGGAAGG	GA
ACCGGTTGCATAGCCGCGC	AT
TTTCCAGATGGTGTTCGGT	AC
TGTCTGCTGCCAGTTCCGC	TC
ACACCGTTAATTTGTACCG	AT
GTGTTCGGTCAGCGCATCA	GA
CGGCAAACGTCGCGGCGTT	TA
GAATCCAGCCAGAGCGGTA	CG
ATGCGATAAACTTTTCCGG	TC
CCGTAACCCGCGTTACTGG	CC
GCGATAAACTTTTCCGGCA	TA
CCACATCAACTTCACGGGC	GT
GCGGGAAGTGCAGGGCTTT	AG
GCTCGTGAAAAAAAGGCGT	GC
CATTAACTCCTTAATTCCG	GC
AAATTCCACAGCATCGAAC	GC
CGCACGGGCTGCAAGTGCC	CA
TGCGTTTATCGCCCGGTCG	AG
CATCTTCGCCAGCGGGCAC	GG
CGATACCGACATGAAACTC	AA
CAGCAATATGTACGCCCGC	GT
TGCGAGCCTGGTTACCGTT	TT
GGCTGATCACCAGTGCGTC	AG
GTTGCCAGATTTAAGGGCG	AA
AATGCTGTTGAGGCCAATG	CG
TGAGGCCAATGGCAGCGGG	TA
ACTGGCTTTTTGTGCACCG	GT
GATTTCGCTCCCGGTAGAG	TT
ACCTGTTTAACCTGGGCCG	CC
GGAGGTCTCACCGCCTGCG	CA
GGTAGACCGTTTTCCACCA	TG
TTACCGTTTTCTTGCGCCC	GA
ATCCACCACATGACGCATC	CC
CTGCTCCCATTCCCATTGA	GC
CGTCATCACCGAAGTTGCC	GA
ATCGAACCCGGCTTTTCGC	CG
CTAGCGATAGTGGAAGAAA	AC
CTGGAAGATAACGGTATGG	GT
GCCTGCCATCACATGGACT	CT
GAAGATAGCTGTCGGTCAT	GG
AAAGCGCCGTCGACCATGT	GG
AATTTGACGGTAATGTGCT	CA
GAGGCCATGACAGTCATTT	GC
ACCCTAAGCCAACGATACC	GG
CCTGGTTACCGTTTTCTTG	GC
CCGTACTGTCGAAAGTAGA	GG
TTGGTCACGACGTCATACA	AT
CTGCCGTACCGGGTTTCAG	AA
ATAGTGGAAGAAACCATTA	GC
TCCGCGGCGACTTTGGAAA	AG
GTTAGTTGCGCCGCGCACG	CT
ATCCACACCTTGTTCGAAA	CA
CGCCTGTTTCACCAAACAG	AC
CTGCCTGACTGGCTTTTTG	AT
AGGTCGATGTCTGCGTGTG	CC
AGATCCCGTTTTCATCTGC	CT
CTTTCACCGCAAACCACTG	GG
GGCCATGACAGTCATTTCA	AC
TGCCAGCCGAACCGGTTGC	TA
GCCCGGTACCGTTCAGCAT	TC
GCCCACTGCCGGGCCAGGC	CC
TTCCAGCACGGGTGCCAGT	CC
CCTTTTATTCCCAGGCTCT	CG
ATAAATTAACATTGTGTGT	CT
GCCGAACCGGTTGCATAGC	AC
GACGGTAATGTGCTACCTG	TG
GCCAGCAGTTGATTCATTA	GC
TGGCGCATCCAGCATTTCC	CA
CTGGCCCAGAACCCACTCT	CG
TCGGCAACCAGACCAAGAT	AC
TGAAAGAATGAACTGGCAA	CT
CGCGCCGCTAGTTGAGAAA	CA
GCGCATCAGCACTAGCGAT	TA
CGGGGTGTAATCGCCATCC	GA
TAACCGCGCCGCTAGTTGA	CG
AGGGAAACAGAAATTCCAC	TA
CGCAAAGCGGTCGGCAGCG	GT
GGTATTGAACAGCGCCAGT	CG
ATGGTGTGAACGGACGAAT	TA
TGGAACACCGTTAATTTGT	TA
CCGCGGCGACTTTGGAAAG	TC
CACGGGCTGCAAGTGCCAT	GC
GTCGATGTCTGCGTGTGCT	GT
AGAATGTCAGCAGGACAAA	TG
TCGATTGCTTCCGGCATTT	GT
GCCAGAGCGGTAGCAATTT	AC
GGTCAGCGCATCAAGCACC	CG
TGCTTCAACTAATATTCGC	GT
ATTGTGTGTTATTTTATGT	CG
AACTCAGATCCCGTTTTCA	AT
CCTGTCGGTGTCGCCAGTA	AA
TGCAACGCCTGTTTCACCA	GA
GGGCGAGTGAGACAGGCTT	AA
CACGGCACGCCGGGGAAAT	CG
CTCCTTGTTAATTTAAGTG	TA
ATCGGTAACCGGGCCAATA	CT
CCGCACGGGCTGCAAGTGC	CC
CCGTTGACCGGCAGGGCCG	TG
CAGGCTTATCCAGTGCGTT	AT
TGTGAACTAAGCGTTAGTT	AG
GCGGACGCCCTGCTTTGCG	AA
GGTTGCATAGCCGCGCTGA	CA
AGGCATCGGTAACCGGGCC	AA
GCATGAACCGGAGAGCACT	AA
CCCGCATTAATATCTCCGG	CG
CCCGTTACCAGTGGGGCAT	GC
ACTTGTTCACAATTGAGCG	GC
GGCGCATCCAGCATTTCCA	TG
AAAGCGGTCGGCAGCGTAG	CC
CGCACGTTTCGCAGGCAAA	GT
TTCGCCGTACTGTCGAAAG	TT
TAATGTGCTACCTGGCGGT	GT
ACGAGGCATTGCATTAACT	AC
GTTGCAACCAGCTCAGAGC	TC
CAATGCGTCAGTGCTGGCG	CG
TGGGCCGCATTGACCACCA	CG
TCCGCATCACCACGTATGG	AT
AACCGGTTGCATAGCCGCG	GC
TATGACAGTGCTGCTCCCA	AT
GCCAATATTACCTTTCGCC	GG
AAACTGGCGATATCCGTCG	AC
TTTTTCGGCAAACGTCGCG	GG
AAGCGTTCAATAAAAGGCA	GC
GTATCGGCAACCAGACCAA	TG
CTCTCCTTGTTAATTTAAG	GT
AAACTCAGATCCCGTTTTC	GA
GCCGGGGAAATGGTTGGGC	CC
AATAGATCTGTTTGCAACC	AT
CGGACATATGACAGTGCTG	GC
CCTAGTCCCGGTTCTGCAC	AC
TGGCGCATCCCGGATTCGG	AC
CGGCACGCCGGGGAAATGG	AT
CCCTGATAAACCGTACGTC	CC
GCACCAGCAGTGCGTCCAG	AT
GTGTGGCGCAAAGCGGTCG	CG
ATCCCGTTTTCATCTGCTC	GT
TCAGATGGTTTTGCTCCAG	GT
ACCGTTTTCCACCAGAAAA	GC
GCAAAGCGGTCGGCAGCGT	CA
GTGTGGCTTCAACCACTGG	TA
AACTAACGGACAGAATGAA	GT
ATAATGAGGCTTAACGCCG	GG
GCGTTAGTTGCGCCGCGCA	AC
TTTCACCGTTAGCGGCTTT	AT
CGAAATCGCTCATGATAAA	GA
TAGCTGTCGGTCATGGGAT	AT
GCTAGTTGAGAAAACAGTG	CT
ACGTCCGTTGACCGGCAGG	TG
AGCCCTTGCAGGCAGGAAA	CG
CATGTGCCGAAACGACGCC	AG
TGTGTGTTATTTTATGTGA	TA
TAGAGCAGTATTTGAAATA	GG
AATTTCTTGCGCATCAGCA	CC
TGATATTGTGAATATAAGC	TG
CTTCCGCTGCTAACCGCGC	CC
ATTCGGCCAGCAGTTGATT	GC
ACTGGACAGGAGCGCGTTT	CT
CATTTGAGAGCATGAACCG	TG
GACGCCCTGCTTTGCGAGC	GC
CTGGCTGGAGAAGAGATAA	AT
CGCAATTTCACCTGCGGTC	CA
ATCTGATTCACATAAATTA	GA
ATTCGCTTGCCGTGTGGCG	TC
TCGCCCGGTCGGTAATAAG	AG
CATTTCACCGTTAGCGGCT	TT
GAATATAAGCGCTGGAAGA	TT
CGCCAAATCATCCTTGAGA	TT
TCACCAGTGCGTCGATTGC	AT
AGCGGTATTGAACAGCGCC	GA
CAATTTGACGGTAATGTGC	GT
CGAATCCAGCCAGAGCGGT	TA
GCGCCCAGCGAGCGGACGC	CC
GCACGTTTCGCAGGCAAAT	CA
TATTTTGTTTGATATTGTG	AA
AGGCATTGTCAGTATTGCT	AG
AAAGACCTGCGCGGACATA	GT
TACCGTTTTCTTGCGCCCA	TC
CAGAAATTCCACAGCATCG	AA
CGGGCACGACGCCTGCCAT	GC
AACGGATCGGGCGGTCACC	TG
GGGGCATCGCGCAAGGCTT	TC
GTCGCGGCGTTATCAGAAA	CC
CCAGGTCGATGTCTGCGTG	GT
AACATCATGGATAAATTAG	GC
GCAGCGTAGCGGATATTAT	GC
AGCGTAGCGGATATTATCG	CA
AGCCAGCTCTTGACGAACG	GG
TGTGGCTTCAACCACTGGA	GC
TACGCCCGCTAACAACTGG	GT
AGATCTGTTTGCAACCTTG	TC
TTTTACCTGTTGGAACACC	AG
TCTTTCGAGGGTTTGTCAC	CC
GACCAAGATCCTTAACAAA	AA
CCGGTTGCATAGCCGCGCT	AG
CAGCGGGATCCCCGCACGG	CG
TTTTCCGGCAACGGCTTCC	CA
ACCGACATGAAACTCAGAT	TC
GTCAGATGGTTTTGCTCCA	TG
GCTAACCGCGCCGCTAGTT	TG
CCGCATTGACCACCAGCAC	GC
TTCAACGTAGCGCAGGCAT	TT
TTTCGGCAAACGTCGCGGC	TG
TGAATGCGGGGTGTAATCG	CC
ATCCGTCGCGCCGGTAAAA	TT
AATATGAAACCCTTTTATT	CC
CGGCAGGGCCGGAGAGAAG	CA
GCTGAAAAAGGCATTGTCA	AG
GGTCTGCGCCCCAGGTAGA	AA
CAATTTCACCTGCGGTCAG	GA
TTGGGCCAATATGAAACCC	GT
CGAGGCATTGCATTAACTC	AC
GCCATCCGCGGCGACTTTG	CG
GAAAATCTTGATAACTGCG	AC
ATTGGTCACGACGTCATAC	CA
GCCAATATGAAACCCTTTT	GA
AGGCCAATCGCCAGACCAG	CA
CCACGGCACGCCGGGGAAA	CT
CAAAGCGGTCGGCAGCGTA	GG
GATATTGTGAATATAAGCG	TC
CATCAAGCACCGCGTAGCG	GG
ACCAGCGGGACATTTCCCA	CT
GCATTGACCACCAGCACCA	CG
CCATCACATGGACTTGTTC	GA
AGCAGGACAAAGGAAGGAG	CC
GTTGGCGGCTTCTTGCAGG	TC
GTGCACCGTATTGCTGTTG	TA
AAACCACTGGGCCATGATT	CT
CCTGTTTCACCAAACAGCA	GC
GTCGTTCAAAGGCAATATC	AG
AGCACCTGCCTCTTTCAAC	AG
CTCCGGCAGCAATATGTAC	GG
TGATATTTTGTTTGATATT	GG
GCGTTTTCAGGCTGATCAC	CC
GCAGGGCTTTGGCTGTATC	TG
CACCTATGCGATAAACTTT	GT
GATTGTCTGCTGCCAGTTC	TC
ACCGAAGTTGCCAGATTTA	CA
GCAGGAAAGCGCCGTCGAC	GC
GGGCCGGAGAGAAGACCGT	AA
TTCGCAGGCAAATAGCGTA	TG
AGGCTCTGTGTGACTACGC	CC
AGAATGAATGTGTCACATA	CT
GGCGAGTGAGACAGGCTTA	GT
GAAACTGGCGCATCCAGCA	AT
GTTGCGATACAGCGCCAGA	TT
CACCTGTTTAACCTGGGCC	GG
GTATTTGAAATAGATCTGT	AT
GACAGGCTTATCCAGTGCG	AT
GGTGTAATCGCCATCCACC	GA
ATATGAAACCCTTTTATTC	AC
CCGGGTGATGGCGCATCCC	AG
GAAGTGCAGGGCTTTGGCT	GG
CGGGTGATGGCGCATCCCG	CG
ATAGATCTGTTTGCAACCT	AT
AAGCCGCTGCGGATCGAGA	AT
CTGCCCGGTACCGTTCAGC	AA
CGTTTCCTCCAGCTCTTCC	CA
TCGAGAGCATCCATTAAGG	GC
TGATGCCAGAGAAAATCTT	GG
GCCAAATCATCCTTGAGAT	CG
GGCCGCATTGACCACCAGC	GA
AACTGGTGAATAATTTTTA	CC
CGTAGCGGATATTATCGAT	GA
GAATTGCTGCCAATGCGTC	TA
GACGTCATACATCACATCC	CA
CTCCTCTCGCAAAGACTGC	TT
CATTGACCACCAGCACCAG	GC
GGGTGTAATCGCCATCCAC	GC
AGTTCCGCCAGATCCTGTG	CC
TCTGCTGCCAGTTCCGCCA	GG
CCCGTTTTCATCTGCTCTC	TC
CAATGCATATTCCAGTGCC	CA
CCGGGGCTGAGTGCTTCAA	GC
TAAATTAGCTGCAAAACGA	AG
ACCACCAGCACCAGCAGTG	GC
TACATCACATCCAGCGGGA	AT
GTTTCAATTGAGAGGCAGC	AG
TTGGAAAGCCGCTGCGGAT	TC
CCAGCAGTGCGTCCAGTTT	AT
CGCCGCGCCCAGCGAGCGG	AA
TGCCACATCAACTTCACGG	GG
CTTCAACCAGACGGGGAAG	GA
AGGCAGGAAAGCGCCGTCG	CA
CCACTCTGCCAGTTCGTGT	CG
CAGGTAGAAAGACCTGCGC	CG
ACCAGCTCAGAGCCGCCAG	AC
GCAATATGTACGCCCGCTA	AA
GGGACATTTCCCATCCGCA	CT
CATCATGGATAAATTAGCT	AG
CCGCCCGTTACCAGTGGGG	AC
TGTGGATTGCGCTTCAACC	CA
CAGTGCTGGCGGTGGCAAA	TA
TGAACTGGCAATCCGCGTC	AA
GGCATCCACACCTTGTTCG	CA
GCCGCTAGTTGAGAAAACA	CG
GCTTCTTGCAGGCTTTCAC	GC
GAGCATCCATTAAGGCATC	AG
CGCTCATGATAAAAACTCT	TC
GGGCTGAGTGCTTCAACTA	GA
TTTCGAACATCCAGGAATT	TT
TACTGGCTGGAGAAGAGAT	AA
TGTGCTTCGTGCTCACGTC	GC
CGTTAATTTGTACCGTTGG	CT
CTCTCGCAAAGACTGCTCT	CA
CATCGCTTCGGCTCCGGCA	CG
CGGCCAGAGTTTCAATTGA	GG
AGCATTTCCAGATCGAATC	CC
GAGAGAAGACCGTAAACGG	GC
GCTTTGCGAGCCTGGTTAC	TC
TCATTTCACCGTTAGCGGC	GT
CAATTTCTTGCGCATCAGC	GA
CTTTTTGTGCACCGTATTG	GC
CCGCCAGCGATTGCTGTGT	GG
AGGCAAATAGCGTAGAATG	CT
ATTCCGCAATTTCACCTGC	AG
TACAGCGCCAGATGAAAGA	AG
CTTAATTCCGCAATTTCAC	CC
ACAAAGGAAGGAGCAAAAG	GT
GTTTCCTCCAGCTCTTCCA	CT
TGTGTGACTACGCCGGAGG	CT
CGCCGGTAAAATCATCGGC	GG
GGCTTCCAGCACGGGTGCC	CA
GCCCCAGGTAGAAAGACCT	CG
ACGTATGGTGTGAACGGAC	CG
TGAATGTGTCACATATGAC	AC
CGGCTCCGGCAGCAATATG	TT
AGAGAAAATCTTGATAACT	CG
TGCGTGTGCTTCGTGCTCA	CC
CGCGGATTGTTGCGATACA	GG
GAATTTCCAGATGGTGTTC	TG
CAGCGCGGATTGTTGCGAT	AA
TCGAGATTGCCCAGGCATG	AA
TGGACTTGTTCACAATTGA	AG
TACCCGTAGAGCGTCGCCA	AA
